━━━━━━━┓WPWP┃P┃MPPWP┗EW║P
MMMPEWP┗━━━━┛W┗┓PWPPPWME┃
MPMWPPPMMMMW⬓MP⭐━EP☾━━━━┻
MPPPWWPPWMMWPWPW┃PPPEPWEP
EWPEMEP◨PWPEPWP┏┛PePPWP┗E
PPPWWPPWMPWPP┏━▦WPW⋄PPWP┃
━━━━━┓PPWPWPW┃PPWEPWPM▦P┃
EPP🠹W┃PℲPEPWMW┃PPW▦P⋄WP⬓┫
╏═M🠻MWPP┏┛PMMP┃WPWPWPPP┣⬓
┃PPPMMW┏┛PWMMW┗━━━━━━━━⭐P
┃EWPMM┏┛PPM⬓PPPPPWMMMEPPO
┃PMWMM┃PWPWPPEPWEPPWPWPWO
▦PPPWP┃◨WPPWPWEP┗━━━━━━P🠸
WPMEPEPWWPM▦PPPPWPWMPWME🠸
PPWP🠺PPMEMMEPW🠻PPWPWePWP◨
MMMPPWPPPM┏━━┓WPW╏🠻PPPWE┣
MMMMEMPPE━EPW┗EP🠻WEWWWPP┃
MM▦PMEWPWPWMMPW🠺EWPEPPPW┗
PWP🠹🠹🠹PPPEPMMWPWP⋄PWPWEPe
EMW🠻🠻🠻╏╝└PPPMPP⋄━━☾PE━━━━
PMPPPPEP║WEWMWPPWPWPWPPWP
⋄W╏🠹WP╔═╝PMMMPW⬓PEMWEPePW
W┗WP┃P╍━━┛MEPPPPPWMPPWP╍P
PPPP┃E║WPMPMPPWPWPMWWE┏╍P
MW▦━┛M║WPW╶─┘PPPPE━━━━┛MW
