--------E-------------------------------------------------------------------oooooooo----------------
----------------------------------------------------------------------------------------------------
---------------------------XXXX--------------------------------------------------E------------------
---------------SS--------------E------------------------------------------------<>----------------XX
------------------------------<>------------------------------------------------[]------XX--------XX
--------------------------------------------------------------------------------[]-XQQQQXX----------
--------------------------------------------------------------------------------<>------------------
--------------------------------------------------------------------------------[]------------------
--------------------------------------------------------------------------------[]------------------
--------------------------------------------------------------------------------[]------------------
---------------------------------------------------------------EX---------------[]--XXX-----------S-
---------------------------------------------E---------------XXXXXXXXXXXXXXXXXXXXXXXXXXX------------
--------------------SSSSSSSSSSS?-------------E---E-----------XXXXXXXXXXXXXXXXXXXXXXXXXXXXX----------
------X--------------XXXXXXXXX---------XXXXXXXXXXX---------E-XXXXXXXXXXXXXXXXXXXXXXXXXXXXX----------
XXXXXXX-----------XXXXXXXXXXXX-XXXX-XXXXXXXXXXXXXX-----XXXXXXXXXXXXXXXXXXXXXXXXXXXXXXXXXXX----XXXXXX
