----------------------------------------------------------------------------------------------------
----------------------------------------------------XX----------------------------------------------
----------------------------------------------------XX---------------XX-----------------------------
---------------------------------------------------------------------------------------------------Q
-----------------E-----------------------SSSSSSSSSXX-----------------------------E------------------
--------------------------------------X-----------XX----------------------------<>------------------
-------------------------------------XX-----------XXE---------------------------[]------------------
--------------------------------------------------XXQQQSSSSSS-------------------[]------------------
--------------------------------------------------------------------------------[]------------------
--------E----------------E------------------------------------------------------[]-----------QX-XX--
-------<>---------------<>---E--------------------------------------------------[]------------XXXX--
-------[]---------------[]--<>--------------------------------------------------[]------------XXXX--
-------[]---------------[]--[]-------------------------------------------E------[]--------------XX--
-------[]---------------[]--[]------------------------XXEXE--------o---XXXXX----[]-------E------XX--
XXXXXXXXXXXXXXXXXXXXXXXXXXXXXXXXXXX-----------------XXXXXXXXX---XXXXXXXXXXXX---XXXXXXXXX------------
