-----------------------SSSXX-------XXXXXXXX---------------------------------------------------------
--------------------------XX-----------------------------------XX-----------------------------------
---------------------------------------------------------------XX-----------------------------------
------------SSSS-----------------SSS-----------------------------------------------------<>---------
--------------XXX----------------SSS-----------------------------------------------------[]---------
-----------SS-XXX----------------SSS--QQ-------------------------------------------------[]---------
---------------------------------SSS-----------------------------------------------------[]---------
-------------------------X--------SS-----------------------------------------------------[]---------
-----X-----------------------------------------------------------------------------------<>---------
-----X----------------------------------------------------------------------------------------------
---XXX----------------------------------------------------------------------------------------------
-------------------------------------------------------EE-------------------------------------------
------------------------------------------------XXXXXXXXXXXXX--------EESSSSSS-----------------------
---XXXXXXXX----------------------------EE------------[]-----X--------XX-----------------------------
XXXXXXXXXXXXXXXXXXXXX-----------------XXXX-----XXXXXXXXXXXXXX---------------------------------------
