----------------XXX------------------------------------XXXXXXXXXXX----------------------------------
--E-------------XX-------------------------------------------------------------------------?--------
----------------XX---------------ooooo--------------------------------------------------------------
---------------------------------SSSSS--------------------------------------------------------------
----------------------------------------------------------------------------------------------------
----------------------------------------------------------------------------------------------------
-------------XSSS-----------------------------------------------------------------------------------
-------------X----------------E---------------------------------------------------------------------
--E------------------------------------------------------------------E------------------------------
-<>----------------------------------EX-----------------------------<>--------------XXXXX-----------
-[]------------------------------E--<--------XXX--------------------[]------------------------------
-[]---------------------------------[--------XXX-------------------QQQ-------------XX--E------------
-[]---------------------------------[--------------------------------------------EEXX-<>------------
-[]----------E---E------------------[------------XX---------EE-XXXXXXXXXXXXXXXXXXXXXX-[]-----------S
XXXXXXXXXXXXXXXXXXXXXXX<>XXXXXXXXXXXX------------XX-------XXXXXXXXXXXXXXXXXXXXXXXXXXXXXXXXXXXXXXXXXX
