---------------------------------------------X--------------------------------------------------<>--
---------------------ooooo-------------------X-------------------------------?SSS---------------[]--
------------------------------------------------------------------------------------------------<>--
-----------------------------------------E--------------------------------------------------XX--[]--
----------------------------------------XXXXXX----------------------------------------------XXXXXXX-
----------------------------------------XXXX---------------SSSSSSSSSSSSSSSSS------------------------
----------------------------------------------------------------------------------------------------
-----------------------------------------------------------------------------------------XX---------
---------------------------SSS----------------------------------------------------------------------
---------------------------SSS----------------------------------------------------------------------
---------------------------SSS----------------------------------------------------------------------
--------------------------------------------------------------------------SSSSSS?-------------------
--------E------------------------XXX----------------------------------------------------E-----------
-------XXXXXXXX------E---XXXXXXXXXXX---E--------------------XXXXXXXXXXXXXXX-------------------E-----
XXXXXX-XXXXXXXXXXXXXXXXXXXXXXXXXXXXX--XXXXXXX---------------XXXXXXXXXXXXXXXX------XXXXXXXXXXXXX-----
