----------------------------------------------------------------------------------------------------
----------------------------------------------------------------------------------------------------
----------------------------------------------------------------------------------------------------
--------------------------------------?----------------------------------------B--------------------
-----------------------------------------------------------------------SSSSSS--b--------------------
----------------------------------------------------------------------------XXXXXX------------------
----------------------------------------------------------------------------------------------------
---------------------------EX------------------------S?SSSSS-E--------------------------------------
----------------------X---<---------------------------------<>--------------------------------------
--E-----------------------[---------------E-----------------[]----------------------oooo-----XXXX---
--------------------------[--------ooo--SSSSSSSSSSSSSSSSSQQQQQ------------------?QQ----------XXXX---
--------------??SSSSSSSSSSXE-------ooo--[]------XX--------------------------------------------------
--------------------------------------XXXXX-------E--------------oooo----------XXX------------------
--------------------------------------XXXXXXXXXXXXXXXXXX-------------S---XXXXXXXXX------------------
---------------------------------X----XXXXXXXXXXXXXXXXXX-------------S--XXXXXXXXX-------------------
