-------------------X----------XXXX------------------------------------------------------------------
------------X---XXXX--------------------------------------------------------------------------------
----------E-----------------------------------------------------------------------------------------
---------<>-----------------------------------------------------------------------------------------
----XX---[]-------------------XXXXXX--------------------------------------------------?Q?-----------
---------[]-----------------------------------------------------------------------XX----------------
---------[]------------------------------------------------XX---------------------XX----------------
---------[]----------------------------------------------XXXX----E----------------------------------
---------[]---E----------------------?QQQQSSSSSSSSSXXXXXXXXXX---------------------------------EXXXXX
---------<>SSSS-----------S-----------------------------XXXXX---------------------------------------
-----------------SSS----------------------------E-----XXXXXXX---------------------------------------
-----------------------------------------------<>----XXXXXXX----------------------------------------
-----------------------------------------XXX---[]---XXXXXXX-----------E-----------------------------
----------XXX----E----------------------EXXXXXXXXXE-XXXXXXX--------------XXXX----------E------------
XXXXXXXXXXXXX---XXXXXXXXX---------------------------XXX---X-------------XXXXX--------XXXXXXXXX------
