----------------------E----------------------------------------------oo----------------XX-----------
------------------------------------------------------------------o--oo--------------------E--------
-------------------------------------------------------------------------------SSS------------------
----------------------------------------------------------------------------------------------------
------------------------------------------EE--------------------------------------------------------
------------------------------------------<>-----SS-------------------------------------------------
-----------------------------------------------SS--------------X------------------------------------
-------------------------------------------------EE-------------------------------------------------
-------------------<>---------------------<>-----------------XX-------------------------------------
-------------------[]--------QQQQ-------------------------------------------------------------------
-------------------[]X------------------------------------------------------------------------------
---------------------------------SSSSSS?SSSSSXX-----------------------------------------------------
------------------------XX--------[]------------------------------------------------------XXXXXXXXXX
--------XXXXXXXXXXXXXXXXXX--------[]--------------XXXXXXXXXXXXXXXXXXXXXXXXXXXXXXXXXXXXXXXXXXXXXXXXXX
XX------XXXXXXXXXXXXXXXXXXXXXXXXXX[]-------------XXXXXXXXXXXXXXXXXXXXXXXXXXXXXXXXXXXXXXXXXXXXXXXXXXX
