----------SSXX--XXXXXX------------------------------------------------------------------------------
------------XX--XXXXXXXXX--------------------------QQQ----------------------------------------------
------------XX--------------------------------------------------------------------------------------
-----------------------------------------X----------------------------------------------------------
----------------------------------------------------------------------------------------------------
---------------------------------------E------------------------------------------------EE----------
--------------------------------------------------------------------------------------SSSS?---------
------------------------------E---------------------------------------------------------------------
-----------------------------<>---------------------------------------------------------------------
----------------------E------[]---------------------------------------------------E-----------------
---------------------<>------[]---------------------------------X-----------------<----------E------
---------------E-----[]------[]-B------------------SSSSSSS-------<>---------------[-----------------
---------------------[]------[]-b----------------X------SS-XXX---[]-------------XXX-----------------
----------XXXXXXXXXXXXXXXXXXXXXXXXX----------X---X---------------[]-------------XXX----------S------
-------XXXXXXXXXXXXXXXXXXXXXXXXXXXXXXXXX--XXXXXXXXXXXXXXXXXXXXXXXXXXXXXXXX-----XXXXXXXXXXXXX--------
