-------------------------------------------------------------------E--------------------------------
------------------------------------------------------------------QQQ-------------------------------
-------------------------------------------------------------------------------------------QQQQQS---
----------XX----------------------------------------------------------------------------------------
------------------------E-----------------------------------------E---------------------------------
-----------------------------------------------------------------<>---------------------------------
-------------------------------------XXXXXXXXX---------X---------[]---XX----------------------------
-------------------------------------------------------X---------[]XXXXX--------XXXX----------------
-----------------------------------------------------XXX---------[]XXXXXE-------XXXX----------------
-----------------------------------------------------XXX---------[]XXXXXXXXXX-----------------------
-oo--------------------------------------------------------------XXXXXXX---XX-----------------------
------------------------------------------------------E----------XXXXXXX----------------------------
---------------------------------------------------X-<>-XXXXXXXX-XXXXXXX------------------E-------XX
---EEE----E--------------E--------------------XX-----[]-XXXXXXXX-XXXXXXX---------XXXXXXXXXXXXXXXXXXX
XXXXXXXXXXX-------XXXXXXXXXXXXXXXXXXXXXXXXXXXXXXXXXXXXXXXXXXXXXX-XXXXXXX---------XXXXXXXXXXXXXXXXXXX
