---------------EE--------------------------XXXXX-------E--------------------------------------------
------------XXXXX-----------------------------------------------------------------------------------
------------XXXXX-----------------------------------------------------------------------------------
-----SSS--------------------------------------------------------------------------------------------
-----SSS?S------------------------------------------------------------------------------------------
----------------------------------------------------------------------------------------------------
----------------------------------------------------------------------------------------------------
-----------------------SSS--------------------------XXXXX-------------------------------------------
-----------------------SS-----------------o---------------------------------------------------------
-----------------------E----------------SSSS--------------------------------------------------------
----------------------<>----------------------------------------------------------------------------
----------------------[]-------------------------------------XXXXXXXXX------------------------------
---------------------XXXXX------------------E----------------XXXXXXXXX------------------------------
---XXXXX--E----------XXXXX------------XXXXXXX----------------XXXXXXXXXXXXXXXXXXXXXXXXXXXX-----------
---XXXXXXXX----------XXXXX-XXXXXXXXXXXXXXXXXX----------------XXXXXXXXXXXXXXXXXXXXXXXXXXXX-----------
