--------------------------------------------------------X-------------------------------------------
------------------------------------------------------------------------------------------<>--------
------------------------------------------------------------------------------------------[]-------E
------XXQQQQQQQQ--------------------------------------------------------------------------<>--------
------------------------------------------------------------------------------------------[]--------
------------------------------------------------------E-----------------------------------XX-----B--
-----------------------------------------------------<>------------------------------------------b--
------E-------------------------------------X--------[]SSSSS----------------------------------------
--------------------------------------------X------S?SSSSSSS----------------------------------------
--------------------------------------------X-----------------------------------------XXXXX---------
--------------------------QQQSSSSSS---------X-----------------------------------------XXXXXXX-------
------------------SSSSSS-------------------------------------------------E------------XXXXXXXXXXX---
---<>---------<>-----------------------------------------------XXXXXX---<>-----------XXXXXXXXXXXX---
---[]----o----[]---------XX--XXXX-----------E-----XXXXXXXXXXXXXXXXXXX---[]-----------XXXXXXXXXXXX---
XXXXXXXXXXXXXXXXXXXXXXXXXXXXXXXXX-----------------XXXXXXXXXXXXXXXXXXX---[]-----------XXXXXX--XXXX---
