-------------------------------------------------------------------------XXXXXX---------------------
----------------------------------------------------------------------------------------------------
-------------------------------------------------------------------------------------S--------------
------------------------------------------------------------------------------------SS--------------
------------------------------------------------------------XXXX---X--------------------------------
------------------------------------------------------------XXXX---X--------------------------------
-------------------------------------------------------------------X--------------------------------
-------------------------------------------------------------------------------------------------E?-
-------------------E--------------------------------------------------------------------------------
-------EX---------<>-----------------------------------------------------------------------------XXX
------------------[]----------------------------E---------------------------------------------------
------------------[]-----------------------------------------------------E--------------------------
---------ooooo----[]----------------XXXX------------------------------------------------------------
--------XXXXXX----[]XXXXX--------E----XX------------------------------------------------BE------XX-E
-----XXXXXXXXXXXXXXXXXXXX--------XXXXXXX---------------------------------------------XXXXXXXXXXXXX<>
