--------------------------------------XXXXXX-----------------------XXXX----------------------------S
----------------S----------------------------------------------------------------------------------S
---------------XXXXXX-------------------------------------------------------X----------------------S
----------------------------------------------------------------------------------------------------
----------------------------------------------------------------------------------------------EXX---
-------------------------oooooooooo----------------------------------------------------------<------
---------------------------------------------------------------------------------------------[------
----------------E----------------------------------------------------------------------------[------
---------E------------------E----------------------------------------------------------------[------
--------<>---------------------o--SS----------XXX--------------------------------------------[------
--------[]------------------------SS---------------------?SSS-------------------------S------Q?-----
------E-<>-----XXXX---------------SS--------------------------------------------------S-----X-------
--------[]-----XXXX---------------------------SSSSS--------XX-------------------------S-----X-------
--------[]---XXXXXXXXXXXXXXX------------------SSSSS----E---XXXX----------------------S------XEE----X
XXXXXXXXXXXXXXXXXXXXXXXXXXXXXXXXXXXX---XXXXXXXXXXXXXXXXXXXXXXXXXXXXX-----------------XXXXXX--------X
