-------------------------------------------------------XX----------------------------XXXXXX---------
--------------------?----------------------------------------------------------------XXXXXX---------
----------------------------------------------------------------------------------------------------
----------------------------------------------XX----------------------------------------------------
----------------------------------XXX---------------------------------------------------------------
------------------S-------------XXXXXE----------------------------------------XXXXXX----------------
---------------------------------------------------SSS------------oooooo-----XXXXXXX-------------oo-
---------oo---------------------------------------XXXXXE----------------XXEXXXXXXXXX----------------
------------------------------------------ES------------------------------------XXXX----------------
---------------------------------------XXXX--E-----------------SSSSSSSSSS------XXXXX----------------
--------------------------------------------XXX----------ooo---SSSSSSSSSS?---E-XXXXX?QQQQ?----------
--------------------------------------------XXX-----------------------------XXXXXXXX----------------
------------------------------------------XXXXX----------------X----------XXXXXXXXXX----------------
-----------------E-----E------------XXXXXXXXXXXXXXXXXXXXXXXXXXXX---------EXXXXXXX----------------E-X
XXX-------XXXXXXXX---XXXXXXXXXXXXXXXXXXXXXXXXXXXXXXXXXXXXXXXXXXXXXXXXXXXXXXXXXXXX----------------XXX
