-----------------------------XXX----------------------------------------------------------XXX-------
------------------------------------------------------------------------------------------XXX-------
----------------------------------------------------------SSS-----------------------------XXX-------
----------------------------------------------------------SSSQ---------------------------XXXX-------
----------------------------------------------------------------------------------------XXXXX-------
-------------------------------------SSSSSSSS-------------------------------------------------------
-------------------------------------SSSSSSSS------------------------------------E------------------
-------------------------------------SSSSSSSS-------------------------------------------------------
----------------------------------------------------------------------------------------------------
-------------------------------------------------------------------XX--------E----------------------
----E-----------------------------------------------------------------------<>---------------E------
---<>--X--------------------------------------------------------------------[]--------------<>------
---[]--X--------------------------------------------------------------------[]--------------[]------
---[]---E-----E---------EE-------------------------------------------------XXXX-------------[]-XXXXX
XXXXXXXXXXXXX<>XXXXXXXXXXXXXXXXXXXXXXXXXXXX---XXXXXXXXXXX----XXX--XXXXXXXXXXXXXXXXXXXXXXXXXXXXXXXXXX
