------------oooo-----------------XXXXXX--------------<>---------------------------------------------
--------------------------------------------------Q------------------oooo---------------------------
---------------------------------------------------------------------oooo---------------------------
----------------------------------X-----------------------------------------------------------------
----------------------------------X-----------------------------------------------------------------
----QQQQQQ?-----------------------------------------------------------------------------------------
----------------------------------------------------------------------------------------------------
----------------------------------------------------------E-----------------------------------------
-------------------------------------------------ooo-----<>-------------S---------------------------
----------------------------------------SSSSS------------[]-----------------------------------------
--------------E---------------E---------SSSSS------------[]-----------------------------------------
---------SSSSSSSSSSSSSSSSSSSSSSSSSSSSSSSSSSSS------------[]------E----------------------------------
-----B---SSSSSSSSSSS-------------XXX--------------B------[]---XXXX----------------------------------
-----b---SSSSSSSSS-----------XXXXXXX--------------b------[]---XXXXXXXXXXX---------------------------
XXXXXXXXXXXXXXXXXXXXX--------XXXXXXX----------XXXXXXXXXXXXXXXXXXXXXXXXXXX------XXX------------------
