------------------------------[]--------------------------------------------------------------------
-----------------------------?SSSS-------------------------------------E------SS--------------------
-----------------------------------------------------------------------SSSQQQ?SSS-------------------
----------------------------------------------------------------------------------------------------
----------------------------------------------------------------------------------------------------
-----------------------------------------------------------------------Xo---------------------------
----X-----------------------------------------------------------------------------------------------
----X------------------------------E----------------------------------------------------------------
----------------------------------<>----------------------------------------------------------------
-----------------------E-------------------oo-------------------------------------------------------
-----------------------------------------------------------------------------E----------------------
--E-----------X-------------------------------------------------------------<>----------o--E--------
-<>--------XXXXX-XXXXXXX-------------------------------oooooooooooooooooooo-[]---------XX----------o
-[]-EXXXXXXXXXXXXXXXXXXX------XX----------Q------XXXXXXXXXXXXXXXXXXXXXXXXXXX[]--------------XXX-XXXX
XXXXXXXXXXXXXXXXXXXXXXXX------XX-----------------XXXXXXXXXXXXXXXXXXXXXXXXXXXXXXXXXXXXXXXXXXXXXX-XXXX
