---------------------------------------oo-----------------------------------------------------------
----------------------------------------------------------------------------------------------------
----------------------------------------------------------------------------------------------------
------------------------------------------------QQ--------------------------X-----------------------
----------------------------------------E-----------------------------------XX----------------------
----------------------------------XXXXXXXXX----------------------------------------------------SSSSS
----------------------------------XXXXXXXXX---------------------------------------------------------
----------------------------------------------------------------------------------------------------
--------------------------------------------------------------------------------X-------------------
----SSSSSSSSSQ--------------------------------------------------------------------------------------
----------------XX-----------------------------------------------------X----------------------------
-----XX----------------------------------------------------------------XE-----------------EX--------
----XXX------------------------------------------------------XXXXXX-------------------XXXXXX--------
-----[]XXXX---------------------X-------------------------------XXX--X----------------XXXXXXEE------
XX-XXXXXXXX-----------------------XXXXXXXXXX----------XXXXXXXXXXXXXXXXX---------------XXXXXXXXXXXXXX
