----XX------------------------------------------------------------------SSSS------------------------
----XX-------------XXXXX------------------------------------------------SSSS------------------------
------------------------------------------------------------------------SSSS------------------------
----------------------------------------------------QQQQQ---S-----------SSSS-------SSSSSSSSS--------
-------------------------------------------------------------E--------------------------------------
-------------------------------------------E--------------------------------------------------------
------------------------------------------<>--------------------------------------------------------
------------------------------------------[]--------------------------------------------------------
-XX----------------------------ooo--------XXXXXXS---------------------------------------------------
---o--------------------------------------XXXXXX----------------------------------------------------
-----------------E----------------------------------------------------------------------------------
------------------------------------------------------------------------------XXXXXXXX--------------
--------------E------------------------------------------------------------XXXXXXXXXXX--------------
-------------------XXXXXXXXE---------------------------------XXXX---------XXXXXXXXXXXX--------------
XXXXXXXXXXXXXXXXXX-XXXXXXXXXXXX------S-----------------------XXXXXXXXXXXXXXXXXXXXXXXXXXXXXX---------
