------------------------------------------------------------------------------------------E---------
-------------------------------------------------------------XX-------------------------------------
--------------------E---------------------------------------EXX-----SSSSSSS-------------SSSSSSSQ----
-------------------<>--------------------------------------XXXXX------------------------------------
-------------------[]--------------------------------------XXXXX------------------------------------
-----------------XXXXXX--------------E-------------------------------E------------------------------
------------------------------------<>------------------------------<>------------------------------
---------------------S--------------[]---E--------------------------[]--X---------------------------
----QQQ------------------------XXXXXXXXXXXX-XXXXXX------------------[]------------------------------
----------SSSSSSSSSSSSSS--------------------------------------------[]------------------------------
------------------XX---------------------------------------o--------[]------------------------------
------<-------------<-----------------------------------------------[]------------------------------
------[-------------[------XXXXX-----XXXXXXXXX--X-------------------[]-------------XXX---------E----
-XXXX-[-------------[------XXXX-E--XXXXXXXXXXXX-------------------XXXXX--------EEE-XXX-------XXXXXX-
XXXXXXX------XXXXXXXX------XXXXXX-XXXXXXXXXXXXXXXXXX--------XXXXXXXXXXX----XXXXXXX-XXXXXXXXXXXXXXXX-
