----E------------------XXXX-------------------XX---------------XXXXXXXXXX--------------------------X
--SSQ----X------------------------------------XX------------XXXXXXXXXXXXX---------------------------
-----XXXXXXXXX---------------------------------------------------------------------E----------------
----------------------------------------------------------------ooo--------------XXXXXX-------------
--------------------------------------------------------------------------XX-----XXXXXX-------------
----------------------------------------------------------------------------------------------------
--------------SSS?-------------------------------------E--------------------------------------------
------------------------------------------------------SSSSS-----------------Q-----------------------
--------------------------------------------------------------------------------------o-------------
----------------------------------------------------------------------------------------------------
-----------------------------------------------QQQQS------------------------------------------------
----------------------SSSSSSSSS---E-----------------E------------XX---------------------------------
----------------------X----------<>---------E------<>----------XXXX---------------------------------
--------------E-------X--------E-[]--------XXXX----[]----------XXXXXXXXX--XXX---XXS---------XXX-----
XXXXXXXXXXXXXXXXXXXXXXXXXXXXXXXXXXXXXXXXXXXXXXXXXXXXXX--------XXXXXXXXXX--XXXXXXXXXX----XXXXXXX-----
