----------------------------------------------------------------------------------------------------
---------------------------------------------------XXXX--------------------------------SS-----------
-------------QQ-------------------------------------------------------------------------------------
----------------------------------------------------------------------------------------------------
----------------------------------------------------------------------------------------------------
----------------------------------------------SS----------------------------------------------------
-----------------------------------------------------------------------------SSS--------------------
----------------------SSSSSSSSSSSSSSSS-----------------------------------SSSS------------X----------
----------------------------------------------------------------------------------------------------
----------------------------------------------------------------------------------------------------
-----------------------------------------------------------------------------------------------XX---
------------------------------------------------o---------------------------o--------------------o--
------------------------------------B------QQQ---SSSSS---------XX----------XXXXX--------------------
-------E-------------------E--------b----------E---------------XX---------XXXXX-[]-----XXXXXXXXXSS--
XX---XXXXXXXXXXXXXXXXXXXXXXXXXXXXXXXX---------XXXXXXXXX---XXXXXXXXXXXXXXXXXXXXXXXXXX---XXXXXXXXXXXX-
