-------------------------------XXX-------E----------------------------------------------------------
-------------------------------XXX--------------------------------------------?S-----------------ooo
------------------------------------------------------------Q---------------------------------------
----------------------------------------------------------------------------------------------------
-------------------------------------------------------------------------------Q--------------------
-------------------------------------------------------------SSSSS----------------------------------
-------------------------------------------------------------SSSSS----------------------------------
----------------------------------------------------------------------------------------------------
----------------------------------------------------------------------------------------------------
---------------ooo-----E----------------------------------------------------------------------------
---------------------E<>------------SSSSSSS---------E---------?-------------------------------------
--------------------<>[]---------------------------<>-----------------------------------------------
--------------------[][]--<>-----------------------[]------------------------o--------------E-XXXX--
-----------E--XXXXXX[][]--[]-------------oo--------[]---XXXXXX------EE----EE--XXXX-----X---XXXXXXXXX
XXXXX---XXXXXXXXXXXXXXXXXXXXXXXXXXXXXXXXXX--------XXXXXXXXXXXXXXXXXXXXXXXXXXXXXXXX-----XX--XXXXXXXXX
