----------------------------------------------------------------------------------------------------
----------------------------------------------------------------------------------------------------
----------------------------------------------------------------------------------------------------
-----------------------------------------S-----------------------------------------------------E----
------------------SSS--------------------------------------SSSSSSS----------------------------<>----
-------------------------------------S---------------------SSSSSSS----------------------------[]----
------------------------E-----------------------------------------------------o---------------[]----
-------------------SSSSSSSSS-------------------------------------------------------E--QSSSSS--[]----
----------------------------------------------------------------------------------<>----------[]----
----------------------------------------------------------------------------------[]--E-------[]----
--------------------------------------------E-----------------------o-----------SS[]-<>-------[]----
-----------------------------B-----XXX--------------------------------------------[]-[]-------[]----
-----------------------------b-XXXXXXX--------------------------------------------[]-[]-------[]----
-E---------------E----------XXXXXXXXXXXXX-------------------------------------EE--[]-[]-------[]----
XXXXXXXXXXXXXXXXXXXXXXXXXXXXXXXXX-XXXXXXXX-----------------------------XX---XXXXXXXXXXXXXXXXXXXXX--X
