------XXXXXSS?--------SSSSSSSSSSSSSS----------------------------------------------------------------
----------------------SSSSSSSSSSSSSS----------------------------------------------------------------
----------------------E-----------------------------------------------------------------------------
------------X--------<>-----------------------------------------------------------------------------
---------------------[]--------------------------------------------------XXX------------------------
----E---------------XXX-----------------------------------------------------SSSSSSS-----------------
----E-----------------------------------------------------------------------------------------------
---<>--XSSSSSSSSSSSSSS------------------------------------------------------------S-----------------
---[]--XX--------------------------------------------------oo---------------------------------------
---XXXXXX-------------------------X-----------------------------------------------------------------
----------------------------------------------------------------------------------------------------
---X-------------------------------------------QQ?S-E--------------------------------SSSSS----------
---X-----------------------------------------------<>--------------XXXX----------------------X------
-EEX--XX-----------E-------------------------------[]-E---------E-XXXXX--------oo--XS----XXXXXXXXXXX
XXXX--XXXXXXXXXXXXXXXXXXXXXXXXXXXXXXXXXX-XXXXXXXXXXXXXXXXXXXXXXXXXXXXXXXXXXXXXXXXXXXXXXXXXXXXXXXXXXX
