------------o------------------------------ES-------------------------------------------------------
----------------------------------------------------------------------------------------------------
-------------------------------------------------------------------------------QQ-------------------
----------------------------------------------------------------------------------------------------
----------------oo-?---------------------------------------------?SS--------------------------------
---------------------------------E------------------------------------------------------------------
-------------------------------------------Q------------SSSSSS--------X-----E-----------------------
--------------------------E---o--------------------------------------------XX---------------------X-
---------------------------[]-------------X-----------------------------------------XXXXX--------XX-
---------------------------[]-------------X-----------------------------------------XX--------------
-------SS------------------[]-----------------X-----------------------------------------------------
---------------------------[]-----------oooo--X----------------XXX----------------------------------
-X------------------oo-----[]----XXXXXXXXXXXXXX-----------XXXX-XXX--E-------------------------------
-XX-------------E--XXXXX---[]----XXXXXXXXXXXXXX---------XXXXXXXXXXXXXX-----------------------XXXXXXX
XXXXXXXXXXXXXXXXXXXXXXXXXXXXXXXXXXXXXXXXXXXXXXXX--------XXXXXXXXXXXXXX-----------XXXXXXXXXXXXXXXXXXX
