-----XXXXXXXX--------------------SS---------------------------------------E-------------------------
---------------------------------S------------------------------------------------------------------
-----XXXX-------------------------------------------------------------------------------------------
------------------------------QQ--------------------------------------------------SSSSS-------------
--------------------------------------------------o-------------------------------------------------
-------------------------------------------------------------------------------------------------SSS
----------------------------------------------o-----------------------------------------------------
---------------------------------X---E---------------------------------------------------------E----
--------------------------------------------------------------?-------------------------SSSSSSSSSSSS
-----------------------------------------------------------------------------------------------X----
----------------------------------------------------------E------------------------------------X----
--------------------oooo-----------------------------------------------------------------------X----
---X----------------------------------XX-------------------------------XX----------------------XX---
----------------------------------XXXXXX------E----------------------E-XXXXE---E---------------XX---
X--------------XXX--------XXXXXXXXXXXXXXXXXXXXXXXXXXXXXXXXXXXXXXXXXXXXXXXXXXXXXXXXXX------XX---XX---
