------E-------------------------------------XX------------------------------------------------------
----------------------------o--------------XXX-SS-----SS-----------------------------------XXXX-----
-----------------------------------------------SS?SSSS----------------------------------------------
-----------------------------------------------------X----------------------------------------------
----------------------------------------------------XXXXXX---------------------E--------------------
----------------------------------------------------------------------S-----------------------------
------------------------------?------------------------------------------------------------SSSSSS?SS
-----------X--------------------------------------XX------------------------------------------------
-------------------------------XX-------------------------------------------------------------------
-------------------------------XX-------------------------------------------------------------------
-------------------------------XX-------------------------------------------------------------------
----------------------------------------------------X-----------------XXX---------------------------
----------------------------------------------------------------------XXX---------------E-----------
-E----E--------XXXXXX--------------E--------X---E-----------------XX--XXX----------XXXXXX-----------
XXXXXXXXXXXXXXXXXXXXXX---XXXXXXXXXXXXXXXXXXXXXXXXXXXXXXXXX------XXXXXXXXXXXXXXXXXXXXXXXXXX----------
