---SSSSSSS------------------------------------------------------------------------------------------
------XXXXXXXXXXXXXXX------------S----------------------------------------------------------------oo
---------------------------------S------------------------------------------------------------------
---------------------------------S------------------------------------------------------------------
-------------SS------------------S------------------------------------------------------------------
---------------------------------S------------------------------------------------------------------
----------------------------------------------------------------------------------------------------
----------------------------------------------------------------------------------------------------
------------------------E---------------------------------------------------------------------------
----------------------------------------------------------------------SSSSS-------------------------
--------------------------------------------------------------------------------oooo----------------
---------------------------E--------------oooo--------------------------------------[]--------------
---B----------------------<>------------------------------------------------------XXXXX-------------
---b----------------------[]-----XXX-------------E--------------------------XXXXXXXXXXXX------E--X--
XXXXX-XXXX----XXXXXXXXXXXXXXXXXX-XXXXXXXXXXXXXXXXXXXXX-----------------XXXXXXXXXXXXXXXXX--XXXXXXXX--
