----------------------------------------XXXXXX------------------------------------------------------
-----------------------------------------------------------------------------------X----------------
--------------------------------QQQ------------------------------------------------XXX--------------
------------------------------------------------------------------------------------------SSSSSSS---
------------------------------------------------------------------------------------------SSSSSSS---
---------------------------------------------------------------------E--------------------SSSSSSSS--
-----------------------------------------------------X--------------XXX-------------------SSSSSSS---
---------------------------------------------------------------<----XXX-------------------SSSSSSS---
---------------------------------------------------------------[----XXX-----------------------------
-----QSS---------E---------------------------------------------X------X---------------E-------------
----------------<>-----------------------------XXXX----------------------------------<>-------------
----------------[]-----------------------------XXXX----------X------------------E----[]-------------
----E--------XX-[]-----E-----------------------XXXX----XXXX---[----------------XXXXX-[]-------------
---XXX----XXXXXXXXXXXXXXXXXXSSSSSSSSSS---------XXXXXXXXXXXXXX-[----------------XXXXX-[]-------------
XXXXXXXXXXXXXXXXXXXXXXXXXXXXXXXXXXXXXX--XXXXXXXXXXXXXXXXXXXXXXX-----XXXXXXXXXXXXXXXXXXXXXXXXXXXXXXXX
