----------------------------------------------------------------------------------------------------
------------------------E----------------------------------<----------------------------------------
----X------------------------------------------------------[----------------------------------------
-----------------------------------------------------------[----------------------------------------
-------------------------------------------------------XXXXX----------------------------------------
--------------------------------------------------------------------------------------------E-------
-------------------------------------------------------------------------------------------<>-------
---------------------------------------SSS-------------------------------o-----------------[]-------
------------E-----XX-------------------E--------------------------------------------------XXXXXXXXX-
----------E-------XX------------------<>--------------------------------------------------XXXXXXXXX-
---------<>--X----X-[]----------------[]------------------------------------------------------------
---------[]--X----X-[]----------------[]--E---------------------------------------------------------
---------XXXXX---XX-XXX-XXXXXXXXX-----[]-<>----EE-E-----------------------------------------XXX-----
--E-----XXXXXX-XXXXXXXX-XXXXXXXXX-----[]-[]XXXXXXXXXXXXXXX----------E--E---------------XXXXXXXX-----
XXXXXXXXXXXXXXXXXXXXXXXXXXXXXXXXXXXXXXXXXXXXXXXXXXXXXXXXXX-X------XXXXXXXXXXX------XXXXXXXXXXXX-----
