---SSS--------------------------------------------------------QQ---------E----------------B---------
---SSS-------------------------------------------------------------------SSSSS----<-----o-b---------
-------------------------------------------------------------------------SS-------[-----------------
----------------------------------------------------------SSS?SSSSSSSS------XXXXXXX-----------------
----------------------------------------------------------------------------------------------------
------------E---------------------------------------------------------------------------------------
----------------------------------S---------------------------X-------------------------------------
----------------------------------------------------------------------------------------------------
----------------------------------------------------------------------------------------------------
--------------------------------------------------------------Q--oo---------------------------------
---------E------------------E-----------------------------------------------------------------------
--XXXXXXXXXXX--------------<>-----------------------------------------------------------------------
--XXXXXXXXXXX--------------[]-----------------------------------------------------------------------
--XXXXXXXXXXX------XXXX----[]----------------E---------X-------------------------E--XX----XXXXXX----
XXXXXXXXXXXXXXXXXXXXXXXXXXXXXXXXXXXXXXXXXXXXXXXXXXXXXXXX-------------------XXXXXXXXXXXX--XXXXXXXXXXX
