--------------------------------------X-------------------------------XXXXX-E--------QS-------------
----------------------------------------------------------------------XXXXXXXXo---------------------
----------------------------------------------------------------------------------------------------
----------------------------------------------------------------------------------------------------
--X--ooo--------------------------------------------------------------------------------------------
----------------------------------------------------------------------------E-----------------------
------------------------------------------------------------------------------------SSSSSSS---------
--------------E----------------------------------E--------------------------------------------------
---------------------------------------------------------SSSSSSSSSSSSS--------------ooooo-----------
---------------------------------------------------------SSSSSSSSSSSSS--------------SSSSS-----------
------SS?------------------------------XX-----------------------------------------------------------
---------------------------------------X-------------------------E------------XEE-------------------
-------QQQ-------------E-------------B-X-----------------X------------------XXXXXX-----E------------
---------------------XXX-----E-------b-X---E-XXXXXXXXXXX-X----E-------------XXXXXXXXXXXXXXXXX-------
XXXXXX----------XXXXXXXXXXXXXXXXXXXXXXXXXXXXXXXX---XXXXXXXXXXXXXXXXXXXXXXXXXXXXXXXXXXXXXXXXXX-------
