------------------------------X---------------------------------------------------------------------
----------------------------------------------------------------------------------------------------
------------------XXXX-----------?--XXXX-------------------------------------------SS--------------E
-----QS-------------------------------------------------------------------?-------------------------
--------------------------------------------------------S-----E--------SSS?-------------------------
-------------------------------------------XXXXX---------oo-----------------------------------------
------------------E-X------------------------------------------------------------------S------------
------------------X---------------------E-----------------------------------------EE----------------
---------------------------------------<>-----------------------------------------------XXX---------
-----------<---------------------------[]----------------E------------------------SSSSS-------------
-----------[---------------------S-----[]---------------<>------------------------------------------
-----------[---------<------------b----[]-------?---------------------------------------------------
-----------[---------[---B--------B----[]-----------------------------------------------------------
-----XXXXXXX------XXXX---b--------b--XXXXXXE-----------E-----------------------E-----oo-------------
XXXXXXXXXXXXXXXXXXXXXXXXXXXXXXXXXXXXXXXXXXXXX--------XXXXXXXXXXXXXXXXXXXXXXXXXXXXXXXXXXXXXXX--XXX-XX
