----------------------------------------------------------------------------------------------------
-----------------<----------------------------------------------------------------------------------
-----------------[--------SSSSSSSSSSS-------------------------------------------SS--------SSSSSSSSSS
----------------XX---------------------------E------------------------------------------------------
-----------------------------------------------------------------------------------o----------------
----?SS--------------------------------------------------------------------------------------E------
------------------------------------------------------------------------------------------SSSS?SS---
----------------------------------------------------------------------------------------------------
----------------------------------------------------------------------------------------------------
-------------------------------------------------------------------------------------------SSSSSSSSS
-------------XX----------------------------------<>---------------------o---------------------XX----
-------------------------ooooo---------E---------[]-----X------E----------------------------XXXXXXXX
-----------------------X------------E-<>---------[]-XXXXX-----------E-----------------------XXXXXXXX
-------E---B-----------XX-------------[]-------XXXXXXXXXX------------------------------XXXX-XXXXXXXX
XXXXXXXXXXXXXXXXXXXXXXXXX-------------XXXXXXXXXXXXXXXXXXX-----------XXXXXXXXXX--------XXXXXXXXXXXXXX
