------------------------------------------Q-----XX----------------------------X---------------------
-------------------------------------------------------QQQS--QQQQ-----------------------------------
------------------------------o---------------------------------------------------------------------
----------------------------------------------------------------------------------------------------
-------------------------------------------------------------------X--------------------------------
----------------------------------------------------------------------------------------------------
---------------------XXX--------------------------------------------?----E--------------------------
------E----------------------------------------------------------------SSS--------------------------
------------------------------------------------------------EE-XXXX----SSS--------------------------
-----SSSSSSS---------------S------------------------------------------------------------------------
---------------------------S-----------------XXXXXXX----------E-------------------------------------
-------------------------------------------------------XXX---<>-------------------------------------
-----S------------------------------------------<------XXXX--[]-Eoo---------------------------------
-------------EE--------XXX-----------XX------E--[------XXXXXXXXXXXX---------------------------------
XXXXXXXXXXXXXXXXXXX-XXXXXX-----------XXXXXXXXXXXX--XXXXXXXXXXXXXXXXXXX-------------------XXXXXXXX-XX
