----------------------------------------------------------------------------------------------------
---------------------------------------------------------------SS--E---------------------ooo--------
------------XXXX------------X-----------------oo----------------------------------------------------
------------------------SSS--?--------------------------------------oooo----------------------------
----------------------------------------------------------------------------------------------------
-----------------------------SSSSSS?SSSSSQ----------------------------------------------------------
----------------------------------------------------------------------------------E-----------------
---------------------------------------------------------------------------E---------------------X--
------------------E--------------------------------------------SSSSSSSSSSSSS---------------------X--
---------------------QQQQS-----------------------XX-------------------------------------------------
---------E-----------------------------------XXXXXX--SSSS-------------------------------------------
--------<>----XX----------------------------XXXX---------------------<>-----------------------------
--------[]----XX---------------------------XXXXX---------------------[]---------oo------------------
--------[]-----------------E---------X-------------------X----o---E--[]------X-----------------XXXXX
X----XXXXXXXXXXXXXXXXXXXXXXXXXXXXXX-XX----------XXXX-----XXXXXXXXXXXXXXXXXXXXX--------------XXXXXXXX
