---------------------------SSSSSSSSS?SSSSS-------------------XXX------------------------------------
-------------------------------------------------------------XXX------------------------------------
----------------------------------------------------------------------------------------------------
----------QQQQQ-------------------------------------------------------------------------------------
----------------------------------------SSSSS---------SS--------------------------------------------
--------------------------------SSS-----------------------------------------------------------------
-----------------------------------o-----------------------------------------------------SSSSSSSSSSQ
------------------------S----------------------------------------------------------------S----------
----------------------<-----------------------------------------------------------------------------
----------------------[-----------------------------------------------------------------------------
----------------------[-----------------------------------------------------------------------------
--------------------EX[----------------------------------------------------------XXXXXX-------------
-------------------<>XX-------------------<-----------X-----o--------------------XXXXXX--XXXXXXXXX--
----------------E--[]XXXXXXXXXXXX------E--[----o------X--------------XXXXXXXXXXXXXXXXXXXXXXXXXXXXX--
XXXXXXXXXXXXXXXXXXXXXXXXXXXXXXXXXXXXXXXXXXX----X-XXXXXX-----X--------XXXXXXXXXXXXXXXXXXXXXXXXXXXXX-X
