┗━PWPM▦P┃PPMMMPP┏┛PEWPW⬓P
PP🠻╏PWPP┃W⬓MEP🠸P┃WP┃PWPPP
WP┏━▦PW┏┛PPWPP🠸P┃ePEMMWPW
PP┃PP⬓P┃WPWPEP🠸P┗━PPMMPPW
MW┃PW┃P┗━━━━┛P🠸PMM⋄PPW┏━☾
PW┗PMWPMMMWP╔P🠸PMPW┃WP┃PW
PPePWPPPWPWP╍P🠸WPMM┃EWEP┃
EPWPPPWPWEPE║EPPW⬓P┃PPPWE
EPPP☾P┏PP┗PP╍━WEPWP┗PWPPW
PPPPPW┃⭐PEW╔╝PPPEPMP⬓PPPW
EPEW▦P┃P┃PP║P┗━━━━━━┛WMWP
MWPWPEPWE┃E╚PMPWMMMWPPMPP
EPEMPPWPW┃PMMMPPMMMPEPWPW
PWMM🠻EPPP┃WPWE🠸PMMPPPPP▦P
ePEMMMPPP┃PPPP🠸PWPℲPeEPWP
WPWMWEPWP┃PMWEWPPPPPWPPPP
┃PWMPPtPPWPPPPMWPMPPEW🠻OP
EPMM╏🠹PMP🠻🠻🠻WWPEPPP┃PPM🠻P
⬓PMPWPPPtPPPW⋄P╔╝PP┃WWPP┃
◨PP▦PM╏🠹P┃PPMPW║P☾P┃W⬓MEP
WPWPPPWPW┗━PW▦MEP🠹P┃PPWPW
WtPPWMPPPPW⬓PWPMPPPE┗EMPP
WPEWPW┗━PWPPEPPP║PWPPWMP⬓
◨PWPPPPW┏━━PPE┓W╚PWPPPPPP
PPPPWPPP┃W▦MWP┗━EWWEPe┗┓W
EWWPWPWP┃PWPEPWPPWWPWPW┗━
