WWEW║PWPWPP┃WP🠸PWMMPPW┗━┛
PPWMEP🠻🠻PEP◨PEPWMMMW▦PMPM
WEPWPPEMPPWPP║P┃W⬓PPW⋄WPM
PPPPPWPPWPP╚╏╩PWPPPWMPPWP
WPW┏━━┓PEWPMPWPWPEPPM╝PP⋄
WEP┃PWEWPPMMWOWPWPEPMPWPP
P┗━┻PMPW╚PWEPWPPPePWMPWEP
WPPPEPP┏━━━━PPPPWPEPW▦PPW
P🠻🠻PPWP┃PWMM╏PWPPPPWWP◨PP
tPP┗━EP┃WeEPWEPWPePEPW┃P☾
EPPPPWP┗━━━━━━━┓PPePPMWP🠹
PWEW▦PPPPWMMMPW┃EPtPWPEPP
MPPWPWPW┓PMM▦PP┃W🠹PMM┏━PW
WPWMMMPW┃MMWPMW┃PPPWM┃W🠻P
PPPWPWPP┃PEPPPE┗┳┛PPP┗━━W
W┏━━━┓⋄PE┃P╚P┃PW┃PPWPMMWW
P┃MWP┃P🠺P┃PM⋄┗PP┗PWPWMMPP
◨┃WWP┗PPM┣PPWEWMW⋄PPPPM🠻🠻
P┗━▦PE🠻PW┃WPPWPMPW🠺EWPMEW
MWPPWPWPW┃PPPPWEWPWP☾PPWM
PEPWePPPP┗PW🠻🠻PPWEPP🠹WtPP
P┃PPPWPEPWePPW║PPPPPPWPEP
PP╚╏PPPP┏━━┛PMEPWPe┗┓EPWP
WPMP⭐WPW┃PWP⋄WP⬓PWPW┗━EMP
WPWPPPPP┃PPPPPPPPPPPPPPPP
WPPWPEPWEW🠻🠻🠻🠻🠻🠻🠻🠻🠻🠻🠻🠻🠻🠻🠻
