------------------------------------XXXX------------------------------------------------------------
----------SSSSSSSSSSSSQQ-------------------------------E--------------------------------------------
----------------------------------------------------------------------------------------------------
------------ESSSSSSS?---------------?------------------------------------X--------------------------
------------------------------------------------SS--------------------------------------------------
----------------------------------------------------------------------------------------------------
----------------------------------------------------------------------------------------------------
-----------------------------------------------------------------XX---------------------------------
----------------------Q----------------------X------------------------------------------------------
-----------------------------------------XXXXX------------------------------------------------------
-----------------------------------------XXXXX--------------------------------------------E---------
----------o------------------------------XXXXXXXXXX------oo-------------------------B----<>-------SS
--------------------------------------E--XXXXXXXXXX---------------------------------b----[]---------
---E--XXXXXXXX-------------------XXXXXXXXXXXXXXXXXX----XXXXXXX----------------XXXXXXXXX--[]---------
XXXXXXXXXXXXXXX-XXXXXXXXXX---XXXXXXXXXXXXXXXXXXXXXXX---XXXXXXXXXXXXXXXX------XXXXXXXXXXXXXXXXXXXXXXX
