WPPPE╍EPPMW┃EPPPPPPM┗━┛PW
PPWPP║WW⋄WP┃PWPMWPPPPPePP
WPPW╔╝PPWPP┃PEWPWPWPePtPP
PPEP║PℲPEMM┣P┃PPE━☾PtWPWP
WPWE╚PPPPMW┃W┃MPWPW🠹PPWWP
WPPPM┃W🠻WMPEP┃WP⋄PWP┗━━▦P
EMW┏━┛PEPWP┃W┃ePPEMMMPPPE
PPP┃PM┃PEMMEP┗━┛WMMMW◍PP┃
P☾PEPW┃PPPPPPMMPPPMMWWPW┗
P🠹P┃PE┗PPWWMWMEe┃MMEPPPPe
W╍W┗PWP🠺tWPMPMMW┃PWPP☾━━━
P🠻PPtWPPPWEPMMMM┃PMPPPEPP
P┏┛WPPPEPPPPMMMP┃WMWPWP╔═
W┃W▦PWPPWPPWMMMWEPPE━━P╍━
W┗━━▦WPPP⭐━━━━━━━━━WPW╔╝P
PMPPPWPWPWPWWMMMWEPPWP║PM
WMPW🠻PEPMPWPPPWEPW🠺EPE╚PM
eE━┓WP┃WM🠻WPPWPPEPWPPPMW⬓
WPW┃WP┃PMEWPEPW━━━━━┓MMPW
WPP┃PPEPWPMPPPWPWMMM┃PWPP
PE━┛PWPPPPP◍║PMMPMWE┗EPPW
PWPeP🠻🠻🠻🠻SOOOOOOWPPPP┃WPP
PPPPtPPPW🠻🠻🠻🠻🠻🠻OPPWPW┃PPW
EWPWP┃PWPMPPPPWM╝┏━━━┛WEe
WPWPP┗PPPM╝└╎PPMP┃PPWPPPW
EPPWPMEPWMPPW┗━EP┗WEMMPWP
