WEPWPWEPWPWPPPPWPWP⋄PtPPW
WPPPWP┗━━━━━━┓PP⬓PPP🠹PWPP
WPWP🠹PWEPPEPW┗PW┃PEWPPW🠺W
WPWPPPPPWPMP⋄PtW┗PPPℲPE🠻P
WPWPW🠻OPPEWPW🠹PPP🠸PPP┃PWP
W⬓PPPPWEPMP◨WPPeEPMWP┃WWP
PW╍PWWPMPWPWW┏━━┓PPEW┗━━P
EP🠻🠻PEWMPPPPP┃PWEP┃PPPWP┏
PWPP┃PPPPWPW⋄┗PPPW┃EWPWP┃
EPWPPWMWPPPPWE┃EWP┃WPWP┏┛
EPMPPPMWP◨WP┏━┛PPP┃WPEP┃P
EWPPWPEPWMPP┃PP╚PW┗━━━PE┃
PW🠻🠻PP┃MMMPP┗WPMWPPWPE┓P┃
WPPP▦━┛MEPMWPPWPPW⬓PWP┗P┗
We┗━┛PMP┃PPPWMP◨MPPPPPPMW
PPWPW⋄WP┗PPPPEW┃WPWPP┃PPP
PWEWMPPEPMWEW🠹P┃PWOPP┗WEP
PPPPW┗━┓PPPMPWE┗EPW┃WPPP◍
PWPePPP┗━━PP⬓PWPWEP┃PPEP┃
PPPPEPWPWe┗━┓MP⬓PWPW┃PPPW
⭐PPMMP🠹PPPWP┃PWP┏━━━┛W⋄P🠻
PWPPPW🠸PPMMW┃EPP┃WPPEMPtP
PPW⬓WPPEPPPW┗━EP⬓PPPWW🠹P┃
EWPPPPPWPℲPPPPPWP┃WP⋄WPPE
PWPPWMMPPPEWMWPPP◨PPPPWP┃
WPP⬓PMWPWPPWMPPℲPW┗━━━━━┻
