WtW╍PWPP🠸PWPPWEPWPWPWPW⬓P
WPP🠻🠻╏P⭐PWPWPPPℲWPM┏━PPP◨
E║P┏━┛PPPPPPPWPPWMM┃W║EWP
W║P┃PPWPWPePPPPWPMM┃E╍PPP
W║P┃PPPPPWPPPWPPW⬓P┃P🠸PWP
MEPEW🠻🠻W⬓PWWEPWPPWE┃⭐PePP
WPP┃PPPWPEP🠺PtWEPPP┃PW🠺WP
WEPE━◨PPPPPP🠹PPMOEW┃PE🠻P⋄
P┗━┛M┃MP╚PEPP┃POOPP┃WPWPP
PEPMP┃WPMMM┃WEWOP┗━┛PPPP⭐
┃PPPP┃WPMPP┃PPPWMWPW🠺EWPW
⋄WPEW┃EPPPE┃PWPPM┏PPWPWPE
WPPPP┃P╚PWP┃PPEE━E🠸PWPPPP
EPePW┗PMMMWEPWMMPP🠸PP╔═╩P
PWPPPePWMPP┗EPME🠸WPWM╝WPW
WPW🠻PtPPPPWP┃PWPWPPPMPPP┏
W🠻PW🠹PWMWWPW┃⬓P▦W┏⋄PPP⭐━▦
MMWWP⬓PMPPWP┃PPW┏┛PWEPWPP
WPW⋄PPPWPWWE┗┳━━┛PWPMPPWP
PPPW┃WEMMPPPW┃WPePP⋄W🠸P┃P
MW━━┛PPMMWPWP┃PPt🠸PPP🠸PE┗
MWPEWPWMMPP🠻MEPWPWWWP🠸PPP
PEPPW🠻PMMPWEMWPWP⋄WPE🠸PWP
P┃EPMMWPMEPPMPtWPPPPP🠸P┏━
P┃PW⬓PEPPWW⋄W🠹PPW└PPEPW┃W
WEPPWPWWPWWWPW┗━━W┗━━▦P┗━
