--------------------------------------------------------------------------------------SSSSS---------
--------------------------------E----------------------?------------------------------XXX-----------
--------------------------------------------------------?-------------------------------------------
----------------------------------------E---------------?S------------------------------------------
----------------------------------------------------------------------------------------------------
----------------------------------------------------------------------------------------------------
-----------------X----------------------------------------------------------------------------------
--------SSSSSSS-XXXX--------------------------------------------------------------Q-----------------
----------------------------------------------------------------------------------------------------
----------------------------------------------------------------------------------------------------
-----------------------------------------------------------------X---------------SS---------EE------
-------------------------------XX--------------QQQQSS--------------------E-------SS-----E--XXX------
---------------------------------------------X-----------X-B----------------------XXXXXXXXXXXX------
-X---------------------XXXXXXXXXXX-----------X---XX------XXX-XXXX-XXX--------XXXXXXXXXXXXXXXXX------
XX-------------------XXXXXXXXXXXXX----------XXXXXXXXXXXXXXXXXXXXX-XXXXXXXXXXXXXXXXXXXXXXXXXXXX----XX
