W┃PP┃W┃PPPP🠻🠻🠻🠻🠻╏╝PPPPPPM
W┃PP┗━┛P⭐PPEMPPPEP☾P◨WPPP
PEWPPPWP🠹WMMM╝PPP🠺PMMPEPE
P┃P⋄PPMM🠻MMMMPM╏PP⋄WPPW┏━
MEPW┃PMMMMMWPPPWEPPPE▦P┃E
WP◨P┃WMMMMPW╚PMPMP☾PMMP┃P
PWPP┗━━━━━━━EPPM┏PPPWPP┃W
P🠻WMMMMMMMWPPW┏━EMWEPPW┃P
WEWMMMMMMWP⋄PP┃PPMPPWEMEO
PWMMWMWEPEPPME┃EPP╔PPMMMM
W┃WPEMPPPPWPPP┃PWP╍┛WMMWM
W┃PP┃WPEW▦PPWEPMMP╍PP◨PPP
P┃⭐W┃MP┃PW🠸PPWWMMP╍EWPEPM
W┃PP┃PPEPW🠸PPEPWPP║W╔MWPW
P┃PW┗W┏┛PP🠸PeP◨WPE╚╏╝PE┓P
P┗PPPP┃P◍P🠸PPWPW┓PMPPWP┗━
MM═P┃EPP┃W🠸PEPPPEPP🠺tWPWP
WMEM┃PEP┃P🠸PPPPPP◍PPPWPWP
PMWM┃MPW┃⭐P┗PMOSOOPPWPPPP
PMPM┃M⬓P┃PMPMMOOOOWPPPMPW
WMMM┃WPPEPPOOOOOOO🠹O🠺WPMP
PMWP┗━┓PWMOOOSOOOOOS🠺PPOP
PWWMMW┗PPMOSOOOOSOOOOSOOm
PWPMMPP☾POOOOSOOOOSOOOOSO
WEPMM╏P🠹OOOOOOOOOOOOOOOOO
PMW⬓PWM🠻🠻🠻🠻🠻🠻🠻🠻🠻🠻🠻🠻🠻🠻🠻🠻🠻🠻
