MMMWWPE┃⭐PWWMMW🠸WMPPPPMWP
W⬓PEPPP┃P▦PPPPPPPMWEPWMWP
PWPPW┏━┛PWPPWPWPPPPWPPPPP
PPEWP┃PePM▦━EPEWEP⬓PPWPWW
PMPPWEPPM┏┛PPPPPPWP▦━━━━━
PMWWP┗┓MM┃PW⬓┃P┃PPPWWPEPW
PPWWPM┃PW┃EPPWMEPPPW⋄PWWM
PPWPWP┃PP┃W⋄PPMEPW▦PWMMMM
WPPPPEP┏P┃WWPPP┃EPWMMMWME
E━PEPPPEM┣━━━PW┗━PMMMMPMW
WP┏┛WPP┃W┃PPW⬓PMM⋄WWPPPPP
┃P┃PPWP┗━┛WEPWPMPWPPWPWEP
EM┃PWMMWPPP┗━━PW▦WEWWP┏━E
PP┃◨PWEPPPEPPW┏━━━━━━━┛PP
┗PWWMPW┛WWPPWP┃WPWPEPWPWP
P◨WPPMPPP⭐━━━━┛PEPP┃WMMMM
MMM🠸PWOWPWPPPEPWMPP┗━━━━━
MMMW▦PWPWPWMPWPPWPPWPMWWP
PMMWPPPWPPPW▦PWEP☾PMPWWPP
PWMPWPWPWP⬓PWPPW🠺PPWPP┏━━
PPPMPPW┏━━┛PPWP🠻WW▦PWP┃MM
PPMMWPP┃WWPPePPEWWPWWM┗━━
PW⬓PPPP┗━━━PtPPPPPPPPPPPP
MPWPWWPPPMW🠹PW🠻🠻🠻🠻🠻🠻🠻🠻🠻🠻🠻
PMMPPPt🠸PPPPPPPPPPPPPPPPP
⋄WEPPWPW⬓W🠻🠻🠻🠻🠻🠻🠻🠻🠻🠻🠻🠻🠻🠻🠻
