---------------------------------------------------------------------------------------------------E
---------------------------------------------------------------------------------S------------------
----------------------------------------------------------------------------------------------------
----------------------------XX----------------------------------------------------------------------
----------------------------------------------------------------------------------------QQQ---------
-------------o-----------------------------------------------------QQQQSS---------------------------
-----------------------SSSSSSS----------------------------------------------------------------------
----------------------------------------------------------------------------------------------------
----------------------------------------------------------------------------------------------------
-----------------SSQQQSSSSSSSS-XX-------------------------------------------------------------------
-----------Q----------------------X-------------------------------------------------E---------------
----------------------------------XX-------------E----------------------XXXX-------<>---------------
-----------------X------E-----------------------<>-----XXX-----------XXXXXXSSSSSS--[]------XX-------
-----EE---------XXXXXXXXX-----EE----------------[]-----XXX-----X---XXXXXXXXXXXXXXXXXXXXXXXXXX-------
XXXXXXXXXXXXXXXXXXXXXXXXXXXXXXXXXXXXXXXXXXXXXXXXXXXXXXXXXXXXXXXXXXXXXXXXXXXXXXXXXXXXXXXXXXX-----XXXX
