EPPEPPMMW┏━┛PPW🠸PWEPPW🠻🠻P
PW┏┛WMMMP┃PP┃PW🠸PPP⋄PPPP┃
EP┃PPWEPW┗━━┻PW🠸WEPPWMMW┃
WP┃WWPWPPPPWPtPPPPWMMMMP┃
PP┗━━P🠻🠻🠻OPPWP┃PEPPMWEMWE
MMWPWtPPPWMP⋄PW┏┛◨WPPWMPW
WPEPWPMWEPEWPEP┃PMPW⬓PPMP
┃PMPP⋄WPPWPWP┃W┃PPPPWEWP◨
PPW┛WPPP▦PP🠹P┃M┃PePWPPPWP
M⬓PPM┏━━┛t🠸🠻W┃P┗━━EPPWM▦P
WP┃PP┃PWPPWEW┗PPPPPWP┃WPP
PW┗━━┻PPWEPPPPMWW🠻🠻PP┃PE┓
MPPWEP┣⬓PW🠻WMPPPPEPMW┗━W┗
WOPP┗━⭐PPPEPWOPPW🠹WP⋄PPPP
EW║PWPPWW┏┛PP🠸PMPPEPP🠸PMW
PMEPPWWPP┃WPEWMMEW🠹PP🠸WMP
PWP◨WP⭐━━┻━━━━⬓PWPWP⭐PPW╔
EPWPWPWPWPWMPWPPPPPPW🠻🠻╏╝
PEPPPWWMPPPWPPW🠺EPMPPPPEP
PPPePWMMWPPMWPPWPWPPWPPPW
PEW🠺EPMMWPWPWMEMP🠻PWOP⭐PP
PWPWPPWWWPPWWMEMWPeP🠸PP┗━
◨PEMWPWW⋄WMPPWPPPWP⭐P┃PMM
PPMMEP⋄WWPW┗━EP☾PPPPWEWMW
WPPWPPPPPPPPPPPPPPPPPPPPP
WMEPW🠻🠻🠻🠻🠻🠻🠻🠻🠻🠻🠻🠻🠻🠻🠻🠻🠻🠻🠻🠻
