PPP┗PPPE┃PWtWMWMW🠸PPP☾P┃W
PMPME━━━┛◨WPPPPPP🠸PEPPP┃P
POPPWPPEPMMPPPW┓P🠸PPPPW┗━
W🠸PPPPPWPM▦PP◨PEP🠸PWPWPPW
W🠸PePℲPEPWPMPWPPE🠸WEPMPPP
W🠸PtPP┃PPPWMPP⋄PPePPWPPWE
PP🠹PEPWMW⋄PEWPPWWPWP┃PEPW
PW🠸PMPPPWW┏━━━PPP⋄PW┗━━▦P
PP🠸WMW☾PPP┃PW⋄WMPPEMPEPPP
PWPPWPPMMW┃MMPPPMPPMPPP┃W
WEWWPEPWMP┃WE━━━E╚POWPW┗━
PPP◨PWEPPM┃PMPMMPMEOPPPPE
EPMMWPP⭐━E┗━┓PWMWPWOWPePW
◨PMEP☾PWPPPP┃PPMMMPWPPPEP
PPWPPPWE🠸P☾P┗━⋄WMPPPMWWPW
WtPWMMPP🠸PPPEPWPW☾PMMP🠺tW
WPMPMM═P🠸PW┏━PMPPP┏━━PPPP
WPPPMMEW🠸PP┃P┏━━┓W┃MW🠻🠻🠻🠻
WPMPPWPPP┃W┃W┃WP┃W┃PPPPPP
PW⬓WPP⋄PP⬓P┗━┛PW┗━┛PE┓PEP
⬓PPPEPW┃PPEPPPWPPPPPW┗━━⋄
☾┃WPWPPEPWP🠻🠻PPEPW🠻🠻PPEPW
P┃PEM╏P┃PPWEW🠸PW⬓PMP┃W┃▦P
P┃P┃PWW┃WPW🠹PPWPWPPW┗━┻━┛
P┗P┗━━━┛PPPWW🠻P⬓PPPPPPPPP
MPMPEWPMWPPP🠺tWPWW🠻🠻🠻🠻🠻🠻🠻
