-------------------------------------------------------------------QQQ--------------------E---------
----------------------------------------------------------------------------------------XXX---------
----------------------------------------------------------------------------------------------------
----------------------------------------------------------------------------------------------------
----------------------------------------------------------------------------------------------------
----------------------------------------------------------------------------------------------------
--------------------------------------------------------E-------------------------------------------
--------------------------------------------------SSSSSSSS------------------------------------------
---------------------------------------------------------------------------------------------------o
--------------------------E-SSSSSSSSSSSS------------------------------------------------------------
------------------QQQQQ--<>-------------------------------------------------------------------------
----E--------------------[]--X--------------o-------------------------------------------------------
---<>------XSS-----------[]--X-------X-------------------------------------------XXXX---------------
---[]---------------E--E-[]--XX------X-X---Eoooo-------------E----------------XXXXXXXX--------------
XXXXXXXXXXXXXXXXXXXXXXXXXXXXXXXXXXXXXXXXXXXXXXXXXXX-------XXXXXXXXXXXXXXXXXXXXXXXXXXXXXXX-------XXXX
