PWWPWPP🠸W⋄WMMMWP⬓┃W⋄┗━┓PP
PEPtWPWPPWPWPPWPPWPWEP┃PE
PP🠹PPPPEPWPPEPWP┏━━━━━┻P║
PW╍PP╠PP┏━┓PPPPW┃WWPWEPE╚
PP🠻╏W║PW┃P┃PMEPP┃EP◨PPWPM
EP┏━━╍EP┃WEPP┃PW┃PWPPWPWM
┃P┃PE║PW┃P┗━━┻━━┻P🠻🠻🠻PPPW
WP┗PW║PPEMMMPPPEPtPPWP╚PP
┃PWMMEPWPMMWPWPW🠹PMPEPMEP
WPMMMM🠻╏PWMWPP⬓PW┏━PPPPWP
WPPWEPPEMMMM┏━┛P┏┛P╚╏╝PPP
◨W━━━⋄P┃PMMM┃PW┏┛WPMPPMWE
PWPWPWM┃W⬓PP┃PP┃PPWMW⋄WPW
WM⬓P◨PW┃PP┃P┃MWEWMPWPWPP┏
PWPWP▦M┗WP┗━┛MPWPMMPEPPP◨
PWPEPWPPPMMPMPPPPPPePWWMM
PPP┃PPWMWMEOO🠻🠻🠻🠻PPW🠻WWME
PMW┃PPPPWMWOPPPPPMPPEPPWP
PPPE┓W🠻PPPPOWPE┓PP☾P┃PWPW
PPWP┗┓WP╚PWOPPW┗┓PPPEP⋄W╔
PPPPW┗EPMWPW┃⬓PP┗PWPPPWP║
EWPPMP┃PPPtW┃PWPEWPEPPP╔╝
MM┣━EPEM╏🠹PW┗EPPMPP┃⭐PW║P
PW┃PPWPPWP🠻PPWPWM╝P┃PWMEP
EP┃MMPPMPtPMPPWMMPWEPPWPW
WP┗━━━WP🠹P⋄W┗━━━━▦PM┗━EP🠺
