--------[]-----------------------------------------------XXXX---------------------------------XX----
--------[]------o-------------------------------------XXXXXXX---------------------------------------
--------[]------------------------------------------------------------------------------------------
--------[]-----------------------------------o------------------------------------------------------
--------XXX----------------------------------------------------------------------------S------------
-------------------------------------------------------SSSS-------------------------SSS-------------
-----oo------------------------------------------------SSSS?-----E----------------------------------
------------------------------------------------------------XXXXXXXXXX------------------------------
-------------XX---------------------------------------------------------------------------------E---
-----------------o---oooo--------------------------------------oo-SSSS-------------------------<>---
-----------------------------------------------------------------------------------------------[]---
---------------------XX----------------------------------------------------------------------S-[]---
-XXXXXX-------------XXX-------E---<-E------------------------<-----XX----XXX---XXX-------------[]---
-XXXXXSSSSSSS-------XXXX----------[---X----------------------[-----XX----XXXXXXXXXXXXXXXX------[]--X
XXXXXXXXXXXX--XXXXXXXXXX---------XX---X---------------------XX------XXXX-XXXXXXXXXXXXXXXXXXXXXXXXXXX
