--------------oooo---------------------------------------------------------------o------------------
-------------XXXXXX---------------------------------------------------------------------------------
---------------------------------------ooo----------------------------------SSSSS--------------E----
----------------SSSSSS------------------------------------------------------SSSSS-------------------
----------------------------------------------------------------------------------------------------
-------E-----------------------SS-------------------------------------------------------------------
-------------------------------SSooo--------------------------------------------------SSSSSSSSS-----
-----E-------------------------SSSSS--------------------------------------------------SSSSSSSSS-----
----<>----------------------------------------------------------------------------------------------
----[]----------------------------------------------------------------------------------------------
----[]----------ESSSSSSSSS---------------------------XX------E----------------------------------E?--
----[]---------<>----------------ESSSSSSS--------------SSS--<>--------------------------------------
----[]---------[]------------------------------------E------[]----ooo--------------------XXX--------
----[]---------[]----XXXX----------------E-----XXXXXXXXXXXXXXX--XXXXXXXXXXXX------------------E---EE
XXXXXXXXXXXX--XXXXXX---------XXXXXXXXXXXXXXXXXXXXXXXXXXXXXXXXXXXXXXXXXXXXXXXX--------------XXXX--XXX
