---XX-----------------------------------------------------------------------------------------------
-----SSS--------------------------------------------------------------------------------------------
----------------------------------------------------------------------------------------------------
-------------------------------------------------------XXX------------------------------o-----XX----
------------------------------------------SSSSSSSSSS-S-XXX------------------------------------XX----
---------------------------------------SSS-----------------------------------------?SSSSSSSS--XX----
---------------------------------------SSS-------------------------EE-------------------------------
-----------------------------o---------SSS----------------------------------------------------------
----------------------------------------------------------------------------------------------------
-------------------------------------------------------------------------------------QQ-------------
----SSS?--------------------------------------------------------------------------------------------
----------------------------------------------------------------------------------------------S-----
------------------------------------------------E---------------------XX----------------------------
--XXXXXSS----------------------------------XXXXXXXXX-------E----------XSS-------------E----E--------
XXXXXXXXXXXXXXXXXXXXXXXXXX-------------X---XXXXXXXXXX--XXXXXXXXXXXXXXXXXXXXXXXXXXXXXXXXXXXXXXXXXX---
