-----------------------------------------------------?-----------XXXXXXXX---------------------------
-------------------------------------S--------------------------------------------------------------
----------------------------------------------------------------------------------------------------
------------------------------------SSS-------------------------------------------------------------
----------------------------------------------------------------------------------------------------
--------------------------ooo-----------------------------------------------------------------------
---------SSSSSSSSSSS-----------------------------------------------------------------------------?--
---------SSSSSSSSSSS----------E------------------------------------------------------------------?--
----------XXXXXXXXXXX--------<>-----------------------------------------------<----------------SS?SS
-----------------------------[]-----------------------------------------------[---------------------
-------------------ooo-------[]-----------------------------------------------[---------------------
-----------------------------[]-----------------------------------------------[---Q-----------------
-----------------------------[]---------E-------------------SSSSS-----------XXX----[]---------------
---------------E-----XXXXXXXXXX----------------E--XXXXXX-------------EE-----XXXXXXXXXXXXXX----------
XXXXXXXXXXXXXXXXXXXXXXXXXXXXXXXXXXXX--------XXXXXXXXXXXXXXXXXXX-X-XXXXX-----XXXXXXXXXXXXXXX---X-----
