----------------------------------------------------------------------------------------------------
----------------------------------------------------------------------------------------------------
----------------------------------------------------------------------------------------------------
--------------------------------------------------------------------E-------------------------------
---------------------------------------------------------------XXXXXX-------------------------------
------------------------SS------------------------------SS------------------------------------------
--------B-E----------------------------------------------XXX--S----------------------------------E--
----XXXXXXXXXX-------------------------??----------------XXX--S---------------------------------<>--
-----------------------------E---------------------------------------------------------o--------[]--
-----------------oooo------SSSSSSSSS--X---------------------------------------------------------[]--
--------------------E-------------XXXXX---------------------------------------------------------[]--
----------------E--<>-------------XXXXX---------------------------E--------------------------X--[]--
---------ooo-------[]--------------------------------------------<>--------------------XXXXXXXXXXX--
-XXXXXXXXXXXX------[]----E---------X---------------E-------------[]-----------E-E------XXXXXXXXXXXXX
XXXXXXXXXXXXXXXXXXXXXXXXXXXXXXXXX-XXXXXXX------XXXXXXXXXXXXXXXXXXXXXXXXXXXXXXXXXXXXXXXXXXXXXXXXXXXXX
