--------------------------XX-----X-------?----------------------------------------------------------
--------------------------XX-------------?----------------------------------------------------------
---------------------------------------------------------------------------QQ-----------------------
-----------------------E----------------------------------------------------------------------------
---------------------SSSSS--------------------------------------------------------------------------
----------------------------------------------------------------------------------------------------
-----------------------------------------------E-----SS-------------SSSSSS------------E-------------
--------------------------------------------------------------------SSSSSS--------------------------
-----------------------------------------------------------------XX-------ooo--SSSSSSSSSSSSS--------
-----------------SSSS------------------------------XX-----------------------------------------------
------------------------SSSSS-------------------------------------------------------------------E---
------------------------SSSSS---------------------------------------------------------E--------<>---
--------<------------------------------------------------------------XXXXXXXXXXXXXXXXXX--------[]--E
-----E--[-------------------------------------------------E--XXXXXXX-XXXXXXXXXXXXXXXXXX----XXXXXXXXX
XXXXXXXXX-----------XXXX--------------------XXXXXXXXXXXXXXXXXXXXXXXXXXXXXXXXXXXXXXXXXXXXXXXXXXXXXXXX
