----------?-------------------------------------SSQ-------------------------------------------------
----------------------------------------------------------------------------------------------------
------------------------------------------------------------------------------------XXX----------XX-
----------------------------------------------------------------------S-----------------------------
--------------------------E-------------------------------------------S-----------------------------
----------------------------------------------------------------------------------------------------
----------------------------------------------------------------------------------------------------
--------------------------------------------------------------------------?-------------------------
-----------------------------------------------------------------------SSS?S-----------------E------
----------------------------------------------------------------------------------------------------
----------------------------------o-EX--------------------------------------------------------------
----------------E-----------------XXXX------------------------------E------------------------------<
--SSS----------<>--------------XXXXXXXXX---------------------------<>---------------------X--------[
-E------E------[]-----E-----E--XXXXXXXXX---------------------------[]-------------XXXXXXXXXXE------[
XXXXXXX-XXX---XXXXXXXXXXXXXXXXXXXXXXXXXX-----XXXXXXXXXXXXXXXXXXXXXXXXXXXXXXXXXXXXXXXXXXXXXXXXXXXXXXX
