WP🠸P┃PPPWPPWPMWPPP🠸W⬓PM▦P
WP🠸PE┗━━━☾PPWPEPP⭐PPWPWPP
PP🠸WPPPWPWPWEPWEP⬓eP⋄PPMW
PWPPEW▦PP⋄PWP◨P┗━┓EPP┃PEP
EPE┓PPWE━━PPWPPWP┗━━━┛PW┏
EPW┃PWOWPP🠸PWPPPPWPPEPEP┃
P◨W┃MPWP╔P🠸PMWW☾PWPPMPPE┃
WPW┗━━┓P╍P🠸PPPPPPPWPW🠸WP┃
W▦PPPP┃P║⭐PWMWPMWP🠻PPPPWE
PW┗PPW┃E╍PEPMWPPPWE╍PEPPM
PPe┃EP┃P🠸PPPMPMP▦PP🠸PMWM┏
PPW┃PWEP🠸PWPMWPWPPP🠸WEPM┃
┃PMWPPWE🠸PMPPPWWPWEWPMWP┃
PPPEPPPPWPMWEPMM▦PWPPPWPE
WW┏━━EWP🠻PPPPEPWP◨PEPPPWP
EP┃PPPPP┏┛PWWPEPWPPPWMMMP
PP┗EWEWP┃WPWWPW⬓PWWPEMMMP
PEP┃PWPP┗━━━━PPWPPPWPMMMP
W┃EPWMPWPEMMWOP🠻╏WPEPMEMW
W┃PPMMPPWPPPP🠸P┏━━━┛PWPPP
P┃⭐W⬓P⭐━━┓OPP🠸W┃PWPM🠻╏PPW
P┃PPWPWPP┗━┓WPP◍PMPPPE┗┳━
PE┃MPPEPPMW┗E🠹OOOOSO🠺PW┃P
PP┃P╚P╔MPMM🠹🠹OSOOOOO🠺WP◍║
WPEPMM╝PMM🠹OOOOOOOOOOOOOO
WPMPWMPWPW🠻🠻🠻🠻🠻🠻🠻🠻🠻🠻🠻🠻🠻🠻🠻
