-----Xooooooo---------------------------------------------------------------------------------------
---------------------------------------------------------------------------------<----E-------------
---------------------------------------------------------------------------------[---<>-------------
--------------------------------------XXX----------------------SSS---------------[------------------
---------------------------------------------XXXXXXXX--------SS------------------[------------------
---------------------------------------------------------------------------------[------------------
----------------------------------------------ooooo-----------------------------XX---------------QQ-
--------------------------------------------------------------------------------XXX-----SQQ---------
----------------------------------------------------------------------------------------------------
------------------------------XXXX---------------------------E---------<>------------S--------------
------------------------------------------------------------<>--------------------------------------
----------------------------------------------<--------X----[]---------------------------------XXX--
-----------------------------------------E-E--[-------XXXXXXXXX--E-E-------------------------E-XX---
------------------------------E-----EE---XXXXXX-------XXXXXXXXX-XXXXXSS----E-------XX--XXXXXXXXXX---
XXX-XXXXXX------------------XXXXXXXXXXXXXXXXXXX---XXXXXXXXXXXXXXXXXXXXXXXXXXXXXXXXXXXXXXXXXXXXXXXXXX
