PPWMPPWMEPPPPW┓PPPWEMM╝PP
W⬓PMWPPMWPEPMPEMPePPMMPPE
WPWEPPWPPP┃PWP┃PPWMEPEPPP
WPPPW▦W╚PW┃PEW┃W🠻PWPPPEPW
WPEWPW┏━━━┻PPP┗━━EMPWWPWP
WPWPEP┃WMPP┣PMMMMPPℲWPPMM
WMMP┃W┃PW┗━⭐WPEMPWPPWP╔MW
PWEW┃W┃WMPPPPWPPPPMPEM╝PP
🠻PWP┗━┻━━┻━━PW╚PWPPMMMPPP
WPWPPPPPPPPE━┓MEPWPEM🠹PPW
EPPPWPE━━━PWP┃PP◨PW┃W🠻E▦P
┃PWPM┏┛MWPtPEPPW┃PP┃MMMMW
PWPWP┃WMW🠹P┏━━━━┻PW┃PPEPE
EPPPE┃PPPPW┃MMPPMEM┃MPPPW
W🠻🠻PW┃WPPPP┃WEWMMMM┃P🠸PPP
PPWPW┃PP╠PPEPWPPWMM┃EWMMM
MPPeP┃PW║PW┃EM╝PPEP┗━━━━━
W┗EWM┣PE╍━━┛PMPWP┃MMWMPEP
⋄P┃PW┃WP║PMPWPWMM┃MEPMMPP
◨P┃WM┃PE╚PPM▦PMMM┃W┏⋄WEWP
eW┗━━┛PPMWM┏━PPWP┗━┛PPPPW
WPPWPP┃WPPM┃M┣◨PPMPePPWPW
WMEPW⋄┗━━┓P┃W┃P┃WMWPWWMWP
MMMPPWEPWEM┃P┃P⬓PMPtWPMPt
PWEW⋄PPPPPP┗PPPPPW🠹PPWP🠹P
ePPMP☾PWWWEP⭐WPMPPWEP⋄WPM
