PPePPMWPPWMPWPWP🠸P┗━━━┛PE
ePW⬓WPPW🠻WM⬓PEPP🠸PPWMMPWP
PPWPP⬓ePEPWP┃PPWPW⬓PWM⬓PW
W▦PE━┓EPPEMP┃WEP▦PPPPWPPM
WPMWP┗━⋄P║WPEPPPWPℲPPWPWP
ePEPPWPW╔╝PPW╚PPMPPPWPPP⬓
MMWWPPEP║P┗━━E╚PWPMWPPEPP
MEPPWPPE╚PWPPPMMPPPEPP║PW
WP⋄PPPPPMWW☾PW⬓P🠸PMP╚╏╩PP
tPPWPWE━EPPPPPWP🠸PPPMPW┗E
WP◨PEPWPPWPP⭐PPEPEPPWtPPW
PMM┏━┳━☾PWEPP🠸P┃PWMWP🠹P◨P
WPE┃P┃PWPP┏┛P🠸W┃EPMWPPPWP
⬓PW┃MEMPW┏┛WEPP┃PPPW🠻🠻PPP
WtW┃WPPMP┃PPWEP┗━━PPWW┗EW
WPP┃W🠹WMEPePPWPWPP☾PWPPWP
PEW┃PPEMWPPPPPWPPPPPM┣PPW
WPMW┃PWME━━━PPPWPWPPW┃W🠻P
☾PPW┃EPMMPPW🠻E▦P⬓PPWP┃PMW
MPWP┃P⋄WEPEPMMMWP┃EMWEWMP
PPMPEWPPWPPPMMMWP┃PMPPPMW
ePP🠺PPPePP☾PEPM┏━┛PWPWPPE
MWPPM⋄PP🠸P🠹PWPP┃PE━━━┓EPW
EPWPPW☾P🠸W🠸PE╚P┗PMPWE┗━▦P
WPPPMPP⭐PPPWPMMW⋄W⋄PPPPPP
MWPEPWPPWPPMWMWWWPW🠻🠻🠻🠻🠻🠻
