PWE╚PWPPPPPE┃PMMWP▦━┛PPMM
PPPM⬓PPW🠻OPP┃MMPWPWWP┃MMM
P◍PWPMEPWM╏P┃WPPM▦P◨W┃WMM
P┃PPEP┃⬓PPWE┃PEWMWMMMWPMM
W┗PP┃M┃PEP🠺P┗━━┓PPWMM┏PWM
PePP┗━┛WMPPEPPW┗━━━━━E🠻PP
PtWPWEPPWPP┃WPPPWWMMMPW━━
🠹PPPP┏━━━━━┛PPW🠻PPWMP◨WPE
PW━┳P┃PEPWEP🠻🠻PMWWP◨WPWPP
MPP┗━┛PPWPPWPWPPPPWPWEPP☾
tWMPPPWEPP◨PEMPW╔══PPPEPP
PPPMWPPP🠻W┃P║W╔╏╝EP┃PPMM🠹
WPPWWEWtPW┃E╚╏╝PP┃M┃WPPW🠻
W🠺WP🠺PP🠹PM┃PMPPEP┃P┗━━⬓PP
E🠻PPP🠸PPPE┃WPPP┃W┃MWPWP☾P
PWPWP🠸PW┏━┛PPME┃P┃MEPPPPW
MPPMW🠸P┏┛P╔╝PWP┃P┃WPEW┏━E
┗PWPP🠸P┃PW║PWOPWM┃PPPW┃PP
PMMME🠸WEPM║PP🠸PPP┃WPPP┃WW
WMMWPePPWM║PP🠸P◍P┃P╚PE┗━━
WMPEPPMMPM║⭐P🠸P┃P┗PMMWPEW
WMP┃M⋄WW⋄W╍PW🠸W┗PW╔MMPP┃P
MMW┃PWPPWP🠻🠻PPPM══╝PWPW┃M
WPE┗EMWP🠺tPP┗━WMEPWPPPE┃P
⬓PPP┃PWPPP┃PMWWMMPEPWPP┃◨
WMEPPEMWWPEWMPPWEWPWEWPWW
