PPPPMP┃WPPP┗PPEPPWP⋄PPPM🠸
WP╚PWPEPEWMWWPPEP🠻PPMWWMW
EPM▦PPWP┃PPPPW┏┛tPePPPPWP
WPWP┗━┓P┃MWEP┏┛PPWPPPePEP
WPPPWE┃M┃WP┗━┛W⋄━━┓PWP┏┛⬓
EWPPPP┃P┃EPPPEMPWP┃MM▦┃PM
WPEW🠻W┃W┃PPPWMM⬓PP┃PWP┃PP
◨PPPPW┗━┻━━⬓PWWPEW┃EPEPEP
🠺PPeEPPEPPWPPPPePW┗━━┛PPW
MWPWPW🠺PEPPEP☾PtPPPPPPPWP
PPPEWPW┃PPW🠹PPWPM╏P┃W🠻PPP
WWPPPPPEPWPWPEPPPW━┛PW┃PP
WM▦━P☾PPEPWePPWMWPPME━┛EP
WMWW🠺PWPMWPPPMPPEPWMWPWMW
WMPPWEMWPPP╚PPWPMPPWPWPP⋄
PMWPPWMPP⭐PM┃WMPP☾PPPPWPP
PPEW⬓PMPPPWP┃PW⋄PPPWEPPWM
PPPPWPM⋄PPEWEPPW🠸PWP┗EWMM
W━PEPWPW╚PPWPEPP🠸PPEPWPMW
PP┏━━┳P┏━━━━━┓PE🠸W┏━━☾PPP
MP┃PP┃▦┃WPWPWE┃PWP┃PPWP⭐━
🠺P┃W┏┛P┃EPPP┏━┛◨PW┃EPPPWP
MW┃P┃P┏┛MMWP┃EPMPP┃PWPePP
PP┗P┗━┛WMMPP┗━E━☾P┗W┃PPMP
EPWMMMPPWMPMPPWPWPPP┗EWM⋄
MWPWEPMWPMEW┗━EWPEWMPWPPW
