-----------------------------------------------------S----------------------------------------------
----------------------------------------------------------------------------------------------------
-----E----oooo------------------------------------------------------------oo----------------SSSS--XX
--------------------------------------------------------------------------XXX---Q-----------SSSS--XX
--------------------------------------------------------------------------------------------------XX
----------------------------------------------------------------------------------------------------
----------------------------------------------------------------------------------------------------
----------------------------------------------------------------------------------------------------
-----------------------------------------------------------------------------------E-E--E-<---------
---------------XXX----------------------------------------------------------------<><>-<>-[---------
------------------SSSS------------------B-----------S-------------------------o---[][]-[]-[---------
---------------E-E----------E----o------b-----------------------------------------XXXXXXXXX---------
-------XXXXXXXXXXX---------<>-------SSS-B-------XX----------------------------------XXXXXXX-----E---
-------XXXXXXXXXXXXX-------[]-----------b---XXXXXX------EEE-------E-----------EE---XXXXXXXX---XXXXXX
XXXXXXXXXXXXXXXXXXXX-------XXXXXXXXXXXXXXXXXXXXXXXXXXXXXXXXXXXXXXXXXXXX-XXXXXXXXXX-XXXXXXXXXXXXXXXXX
