-------------------------------------------------------------o--------------------------------------
----------------------------------------------------------------------------------------------------
--------------------------------------------------------------------------------------------------?S
-----------------------o-----------------XXXX--------------------------------SSSS-------------------
-------------------------------------------------------------------o--------------------------------
----------------------------------------------------------------------------------------------------
----------------------------------------------------------------------------------------------------
-------------------------------------------------------------------------------E--------------------
------------------------------------------------------------------------------<>--------------------
------------------------------------------------------------------------------[]--------------------
---------------------------------------------------------oo-------------------[]--------------------
--<---------------------------------------------------------------------------[]--------------------
--[---------------------------------------------SSSSSS---E--------------------[]------------------B-
--[-------------------E-----E--------E------------XXXXXXXX--E----------XXXXXXX[]-------XX---------b-
XXX----XXXX-------XXXXXXXXXXXXXXXX-XXXX--XXXXXXXXXXXXXXXXXXXX----------XXXXXXXXXXXXX-XXXXXXXXXXXXXXX
