PWPPW┃W┃WPe┃PWMPPPPP┃MPWW
PEP⬓P┃P┃▦PW┃EMMWW🠻PE┗━━━━
PPW┃E┗━┻━EM┃PMPWPWPPWPWPP
WEP┃WPWPP┃P┃PPPPPPP▦PEe┃M
PWE┃PPPPP┃EPWP▦━┓⋄━┛WMW┃P
P┏━┛WMP☾P┗━━━━┛P┃PWPPPPEM
W┃WEMMP🠹MWPMWWPW┃EMMWEWPM
M┃PMMMM🠻PPWPWPPP┃WMMPWPPP
W┃MMW⬓PP◍PPWePWW┃PM┏━━┳PW
M┃WEPW╚P┃W┏━━┳━━┻PP┃PW┃MP
E┗━━━┓M⋄┗━┛WP┃PEPEP┗PP┃PW
WPWMM┃PWEPPPEP┃PP║PWMW┗EP
┗━━┓P┃PPPPWPPPE╚╏╩PPMPPW⬓
PPP┗━┛PPEPEeWPPMPWPWEMPPW
EPWPWPW┏┛PMWPWPPMMWPWMWP┏
PPPP⋄PE┃WPPE━━EPWWWPPPEP┃
┗PPPPWP┃WPPWPPPWWMEPWWMP┗
W◍P╚PWPEPWPMMW┏━━┳━━━━┓PM
WWPMWEPPWPW⬓PP┃EW┃WPEW┃W⬓
PPEPP┗━EPPPWPW┗━━┛PP┃P┃PW
⭐PMWMMPPWPWP⋄PMPPMWP┗P┗PW
MPMPWM╝P🠹PPPP┏━PPPPPPMWMP
┗PWPEMPWP🠸PE━▦P☾PWPWPPEMW
WMMMMMWEP🠸PWPPPPPWEPW━WMP
WMMEMMPWP🠸PPPMWPPPW🠻WPPWP
PWMWWEWP⭐PMPPMMWPWPPWPPMP
