------SSSSSSSSSSSS----------------------------------------------------------------------------------
----ooSSSSSSSSSSSS----QQQS------------------------------------------SSSS----------------------------
----SSSSSSSSSSSSSS--------------------------------------------------------------------------o-------
-----------SSSSSSS--------------------------------------SSSSS---------------------------------------
----------------XX-------------------------------------------------------------------B--------------
------------------------------------------E-------------------------------XXXXXX-----b--------------
--------------------------------SSSS-----<>-------------------------------------SSSSSX--------------
--------------------------------SSSS-------o--------------------------------------------------------
---------------------------------SSS----------------------------SSS-----------------------?SS-------
-------------------------------------------------------------------E----------E---------------------
---------------------------------------E------------S-------------<>--------SSQQQQSQ----------------
--------------------------------------XX------------S-------------[]-------------------------SSSSS--
-------------------------------------XXX-XX-----------------------[]--------XXXXX------------SSSSSoo
---------E---EE----------------------XXX-XX-----------------------[]----Eoo-XXXXX---------E-oSSSSSSS
XXXXXXXXXXXXXXX--------------XXXXXXXXXXX-XX-------------XXXXXXXXXXXXXXXXXXXXXXXXXXXXXXXXXXXXXX------
