WPPPWPEM🠻PPPP┃WPWMWPP┃PWE
ePMPPWPPP🠻🠻🠻P┃PEPPEPEPWPP
WWP🠺tPPPWPPWP┗PPWMWPMPEPP
PPPPP┃W┏━⋄PWPW🠸PMMPPWPM┗P
P☾PWMEP┃PWP⋄PPPW⬓P║PPPEM╏
🠺PWPWPPEPPPW🠻OPPW╔╝└╎PPPW
⋄PEPPPPPW🠻WPPW┃WP║PPWP┃PP
EP┃WPW🠻🠻PEW⊢PP┃PE╚P◨WPE🠸P
WE┗━PPWWPW╔╏MW┗WPMMMMWP🠸P
PPWP🠸PEPP╔╝PMPPPPMMMMPP🠸P
ePPWPMWEW║PWP┏━┓⋄WM🠹MWW🠸P
🠹🠹MMWPWPMEPWPEP┃PPW🠻PPPPW
W🠻PPPEPPPWPWPWW┗EPPPOW◍PP
PWPWPWWPEP⬓PPW⋄PWPWWOWWEP
WEPPPPPWPW┃EPMPW┃PPPWPP┗━
PWPEW◍PWMP┃PWPPP┗┳PMMPPMP
PPPPWW⬓PPM┃WWPWMW┃MMW━━E║
PWPWPPPEWP┃WWPPWW┃MMPPWP╍
PPPPPW┏━━━┻━▦WPPP┗━┓⋄PEP║
PP╚PPP┃PEPMPPWPMMWP┃PWPW╚
WPMMMEPWMWP🠸PEWMMPW┗PEP┏━
WMMPP┃⬓PWPEPWPPWEWPePPW┃P
PMM🠸P┃PWPPPPPPMMPPWPePP┗E
PPMWMEPPPEPP◨PPE━━━EWEPPW
PWPP┏━━━━━┓WP┃PWPPPPPPW🠻P
EMMPEPWePW┗━━┻━━EPWEW⬓PP┗
