------------------------------------ESSSS-----------------------------------------------------------
----------------------------------------------------------------------------------------------------
----------------------------------------------------------------------------------------------------
-----------------SSSSSSSSSSSSSSSSQQQ---------------------------------------------------------Q------
------------------------------------------------------SSSSSS-XXX------------------------------------
-------------------SSSSSS-------------Q-------------------------------------------------------------
----------------------------------------------------------?-----------------------------------------
---------------------------------------------------------S?SSSSQ------------------------------------
----------------------------------------------SSSS--------------------------------------------------
--------------------------------------------------E-------------------------------------------------
-------------------------------------------------<>----------------------SSSSSSQSS------------------
-----<>------------------------------------------[]---------------------------------------------SSS-
-----[]-----?------------------------------------[]------X--------<-----------------E-----------SSS-
---XXXX------------------------------XXX---------[]------X--------[----------X---XXXXXX-------------
XXXXXXXXXXXX----------XXXXX----XXXXXXXXX-XXXXXXXXXXXXXXXXXXXXXXXXXX----------X---XXXXXX---------XXXX
