W🠹PPPPPEPtPE┗━┛PWP┃WEMMMP
WPMW🠻🠻PP🠹PMPWPM▦PP┃PWWPEP
PMMMMP┃W🠸PP▦PPWPPW┗━━▦P┃M
E━━┓P┏┛P🠸PWP┗PPWPMPPPPE┃M
WPP┗W┃WP🠸PMMW━━━━EPWPeP┃W
◨WPPP┃PP🠸PPWPPPWPWPPPWWEP
PWPWE┃P⭐PMWMMW▦PPPPW⬓PPPW
MPtWP┃PWMMPWMPWEPEPPW┃P◨W
W🠹PPP┗PPMMWPPPP┗━━┳PP┃WPW
WPMWPWMWMPPPMWPPPP┗PW┗━EP
WPWPP┃WPP🠸W⋄WPWPEPEW⋄PPPP
P⬓P⭐P◨PP⭐PPWWPMP║PWMP☾PEW
W┃PPMM╝PPWPPPWMW╚PPPPPPWM
W┃PWMMPPPPPMMMM┏━━━WPWPPM
E┗PPWPePWPMMWMM┃PWPPPEMWM
WPeP🠹PPPPPPWWMM┗EPWPMWMPP
MPWPPPWPPW⬓PPWPPWPPWPPWOW
PPPPWPPWtPPPPPPePPePWPPWP
ℲPPWMMPWPEPePEPtWPPWEPP🠻🠻
WPePWMPPPMPP┃PWPPEPPPPWPP
PPPPPPWPPPMMEWPWPWWWEPPWP
W◍PPePPPW⋄WPPMPPPPP🠺PPWPE
WWPWPPW▦WWWPW⬓M🠹M╏PP┃P🠹WP
WPPPWtWPWWMPPPW🠻PW┗EPWPEP
PP⭐PWPPPPEM╏PWMMWPP┃WPP┃▦
WP🠹PEPMWP┃PWWPMMWEW┗━━━┻━
