---------------------------------------------S------------------------------------------------------
----------------------------------------------------------------------------------------------------
-SSSSSSS------------------QQQ-----------------------------------------------------------------------
-SSSSSSS--------------------------------------------------------------------------------------------
-----------oo---------------------------------------------------------------------------------------
-SSSSSSSS-------------------------------------------------------------------------------------------
-----------------------------------------------------ooo-XXX---------------------------------------E
---------------------------------------------------------XXX----------X------------ooooo----------<>
---------XX---------------------------------------------------XXX-------------------------XXXX----[]
---------------------E--------------------------------------------------------------------XXXXXXXX[]
------------------------------------------------------------------------------------------XXX-----XX
------------------------------------------------------------------------------------------XXX-----XX
----B-----------X----------------------------------------------------------------XXX------XXX---XXXX
----b---E-E---EEX-------------------XXX-XXXXX----------XXXSS----XX----XXX---o----XXX----XXXXXXXXXXXX
XXXXXXXXXXXXXXXXX-------XXXXXXXXXXXXXXXXXXXXXXX----XXXXXXXXXXX--XXXXXXXXX----XXXXXXXXXXXXXXXXXXXXXXX
