----------S-----------------------------------------------------------------------------------------
------------------------------------------------------------EE--------------------------------------
----------------------------------------------------------------------------------------------------
----------------------------------------------------------------------------------------------------
------------------------------------------SSS-----------------------------XXXX----------------------
-----------------------------------------------E--------------------------XXXX-----------X----------
-------------------------<--------------------------------------------------------------------------
--------------------------oo-----------E------------------------------------------------------------
---------------------------------------E--------------------------------E---------------------------
--------------------------------------<>-------------------------------<>---------------------------
----------------------------------EX--[]-----E--XXXXX--------XX--------[]----E-----<----------------
-------------------SSSSSSSSSSSSS-<>XXXXXXXXXXXXXXXXX-------E-----------[]-E--E--EE-[---E-----SSSSSS-
-------------------E-------------[]XXXXXXXXXXXXXXXXX------<>-----------XXXXXXXXXXXXX--<>----EE------
--E--------EE----------E-XXXXXXXXXXXXXXXXXXXXXXXXXXX------[]--XXXXXXXXXXXXXXXXXXXXX---[]---XXX------
XXXXXXXXXXXXXXXXXXXXXXXXXXXXXXXXXXXXXXXXXXXXXXXXXXXXXXXXXXXXXXXXXXXXXXXXXXXXXXXXXXXXXXXXXXXXXX------
