W🠻E━━E┃EP║WP┗━┓PWPPWMMEPW
MMMPPP┃P╔╝PPEP┗PWMEMMMMPM
W⬓Pt🠸PEW║PWPPPPMMMMMMEPPE
PP🠹PW┃PW║PPP◨MEWWMMMWPWPP
WW🠸PPEMME┃PW┃WPWMM🠹MPEMWP
WW🠸PWPM┏━┻PP┃PPMMW🠻PPWMPP
WW🠸P┃PP┃PPME┃WPWEPWEWMMWP
⋄W🠸P┃MP┃WM┏━┛tWPWEPWP◨PWE
PPPW┗┓W┃EM┃EPPPPPPEPW┃PPP
WPPPe┗━┛PM┃PPEWW┏━━━━┛WMM
PWMWPWPME━┛PPMPP┃PMMWPMMM
WPPEPPPPWPW┃WP┏PEWMMP⋄WEP
WPWPWMWMMWP┃PPE━━━━━PPPMW
🠻🠻╏PPWP◨PPW┃MPWPW⋄PE┣◨PEP
MPEWMPWP◨WP┃P⬓PEMPMP┃PP┃W
⋄PWPWPMMMMW┃WPMMMPPP┗PW┃E
🠸PMWOPMMMWPEPWMMM╏PMW▦P┃P
⬓PMPWMMMMPPPWMMMPWWPWPP┃⭐
┗PPPPMMWE╚╏PPWMMPPPMMPW┃P
P⋄PPWEPPPMPℲPPMM┣PW⬓PPMWP
WPWPPW╚PPPPPMMMW┃MPW🠻PMPP
PWPEP┏━EW⬓┃PPPEP┃PePMWPP▦
PPPPW┃PPWPWPPMMW┃WPPPWPWP
WPE┓P┃PPPPPPEPWP┃PPWPEPWM
E┓P┃PPWMPeEPPEeWE┗EMWPWPM
W┗━┛WWPWPWPWPMWPPP┃PEPPWM
