---------------SSSSS-------------------------------------------------------------------------SSSS---
---------------SSSSS--------------------------------------------------------------------------------
----------------------------------------------------------------------------------------------------
----------------------------------------------------------------------------------------------------
-------XX---------------------------------------------------------------E---------------------------
-----------------------------------------------------------------------<>---------------------------
-----------------------------------------------ooooo-------------------[]---------------------------
------E----------------------------------------------------------------[]---------------------------
-----------------o------------------------S----------------------------[]-------------------------SS
-------------------------------------------E---------------------------[]---------------------------
---------E--SSSS--------------------------<>---------------------------[]---------------------------
--------------XX--------------------------[]---------------X-----------[]---------oo--------E-------
--------------XX------B-----oo------------[]---------------XXXXXXX---XXXX-------------X----<>-------
--------------XX------b-------------------[]--o------------XXXXXXXX-XXXXX-------------X----[]-------
X-------------XXXXXXXXXXX------X-XXXXXXXXXXXXXX-XXXX-----XXXXXXXXXXXXXXXX---XXXXXXXXXXXXXXXXXXXX-XXX
