--------------------------------------------------XXXX--------------------------------------------Q-
---------------------Q---------------------------XXXXX-------oo------SSS----------------------------
---------------------------------------------------------------------SSS----------------------------
---------------------------------------------------------------SSS---------oo-----------------------
-----------------------------EEE-------------------------------------------------------o------------
-------------------oo-------XXXX--------------------------------------------------------------------
---------------------SS--------------SS-----------------------------------------------o-------------
---------------------SS[]-------------X-------------------------------------------------------------
-----------------------[]--------------------------o------------------------------------------------
-----------------------[]------------------------oo----------E---------XXXX-------------------E-----
-----------------------[]-SSSSSQ-----o----------------------<><----------------------------X-<>-<---
-----------------------[]-----------------------------------[][----------------------------X-[]-[---
--oo-------------------[]-----------------------------------[][----------------------------XX[]-[---
-XXXX------------------[]-------------------XX-----X--------[][----------------------EE------XXXXE--
XXXXX---------------XXXXXXXXXXXXXXXXX-------XX----XXXXXXXXXXXXX-----------XXXXXXXXXXXXXXXXXXXXXXXXXX
