MPMPtW🠻PPPMWE┓E┃P⭐PWPPM┃W
WPW🠹PPPMEWPPW┗━┻PPPMW┏━┛P
E┓PPWWPW┏━━⬓PPPPEWPPE┃WPP
P┗━⬓P◨PP┃PWPM⬓W┏━━┓PW┃W☾P
PPWPMMWWEPP⋄WPP┃PP┃EMEPPW
PP🠻WMPPPM╝PPPEPW┏P┃PP┃WtP
WPEPWOWMMP▦━┳━━━┛ME┃P┃WPM
PW┃PPWPM┏━┛P┃PWEMPP┗P┃WPP
EP┗━━━┓P┃PWP┃PPPP╍EPM┃EMW
PPPWPE┗P┗PWMEPMWP║P┏━┛PPW
PePPePWMWMMMWMMWE╚P┃PP┃EP
WPPWPEPMMMMMPWPPPMM┃⬓W┃PE
🠻P◨PP┃PWMMMMMPEPWPW┃PP┃PP
┗━┛WEPMPPWMWWPPWOPMEPP◨MW
PWPPPOO🠻🠻PPWW🠻EP🠸PMMPW┃WP
PPEPWOPPWPMMMMMEW⋄WMMMWPP
┗PW⬓P🠸PMMPMMMMP┃PWPWMPEPW
W▦PPE🠸W⬓PMMMMMPEPPEPW━┛WM
WPPWPWPW┏━━━━━PPPPWPPPPPE
┃PWEPWEP┃WPEWP⭐W🠻🠻PW🠻🠻🠻PW
PPPWPPPE┃PP┃PPPPEWPPPWWPP
E━EMP⭐PP┃OP┃EPWPPPPE━━▦PW
WP┃PP🠹🠹M┗┓P┃PP🠻🠻🠻PPMPPPPP
EWEOM🠻🠻PP┗PE┃PEPWEPWOPPeP
WPWOMEWPMW🠺P┃P┃WPWPP🠸PWPP
W⬓PWWP☾PEPWW┗━┛tWPPWPWMPW
